,legislador_id,id_hcdn,legislador,Afirmativos,Negativos,Abstenciones,Ausencias,Total,url_hcdn
0,714,596,"ABALOS, Roberto José",61,96,6,50,213,https://votaciones.hcdn.gob.ar/diputado/596
1,376,1531,"ABALOVICH, Eduardo Antonio",41,33,4,22,100,https://votaciones.hcdn.gob.ar/diputado/1531
2,377,1496,"ABAN, Gloria del S.",58,23,2,17,100,https://votaciones.hcdn.gob.ar/diputado/1496
3,3,597,"ABASTO, Angel Leonidas",121,52,0,108,281,https://votaciones.hcdn.gob.ar/diputado/597
4,1156,395,"ABDALA DE MATARAZZO, Norma Amanda",676,51,4,148,879,https://votaciones.hcdn.gob.ar/diputado/395
5,368,1197,"ABDALA, Germán Darío",1,0,0,5,6,https://votaciones.hcdn.gob.ar/diputado/1197
6,818,598,"ABDALA, Josefina",261,139,14,284,698,https://votaciones.hcdn.gob.ar/diputado/598
7,494,599,"ABELLA, Miguel Angel",67,31,5,14,117,https://votaciones.hcdn.gob.ar/diputado/599
8,4,1414,"ABIHAGGLE, Carlos Enrique",78,6,1,54,139,https://votaciones.hcdn.gob.ar/diputado/1414
9,1337,166,"ABRAHAM, Alejandro",327,126,5,32,490,https://votaciones.hcdn.gob.ar/diputado/166
10,928,600,"ACCASTELLO, Eduardo",275,16,14,261,566,https://votaciones.hcdn.gob.ar/diputado/600
11,715,601,"ACCAVALLO, Julio César",104,41,18,50,213,https://votaciones.hcdn.gob.ar/diputado/601
12,1429,572,"ACERENZA, Samanta María Celeste",305,89,2,79,475,https://votaciones.hcdn.gob.ar/diputado/572
13,378,602,"ACEVEDO, Sergio Edgardo",83,17,10,47,157,https://votaciones.hcdn.gob.ar/diputado/602
14,5,1198,"ACEÑOLAZA, Florencio G.",76,11,0,24,111,https://votaciones.hcdn.gob.ar/diputado/1198
15,6,1309,"ACHEM, Antonio",27,31,4,49,111,https://votaciones.hcdn.gob.ar/diputado/1309
16,1033,398,"ACOSTA, María Julia",310,30,1,24,365,https://votaciones.hcdn.gob.ar/diputado/398
17,929,604,"ACUÑA KUNZ, Juan Erwin",387,162,23,260,832,https://votaciones.hcdn.gob.ar/diputado/604
18,1025,603,"ACUÑA, Hugo Rodolfo",390,73,11,170,644,https://votaciones.hcdn.gob.ar/diputado/603
19,7,1245,"ADAIME, Felipe Teófilo",56,67,3,85,211,https://votaciones.hcdn.gob.ar/diputado/1245
20,1034,213,"AGOSTO, Walter Alfredo",168,45,12,140,365,https://votaciones.hcdn.gob.ar/diputado/213
21,930,60,"AGUAD, Oscar Raúl",394,268,66,609,1337,https://votaciones.hcdn.gob.ar/diputado/60
22,260,1310,"AGUADO, Jorge Ruben",8,3,0,3,14,https://votaciones.hcdn.gob.ar/diputado/1310
23,716,605,"AGUERO, Elda Susana",564,38,18,159,779,https://votaciones.hcdn.gob.ar/diputado/605
24,1247,223,"AGUILAR, Lino Walter",125,63,26,193,407,https://votaciones.hcdn.gob.ar/diputado/223
25,1035,472,"AGUIRRE DE SORIA, Hilda Clelia",214,28,6,117,365,https://votaciones.hcdn.gob.ar/diputado/472
26,495,1543,"AGUIRRE, Orlando Raul",22,4,1,9,36,https://votaciones.hcdn.gob.ar/diputado/1543
27,261,1246,"AGUNDEZ, Jorge Alfreso",5,2,0,7,14,https://votaciones.hcdn.gob.ar/diputado/1246
28,1551,1645,"AICEGA, Juan",104,61,0,3,168,https://votaciones.hcdn.gob.ar/diputado/1645
29,262,1247,"ALABI, Ernesto",5,1,0,8,14,https://votaciones.hcdn.gob.ar/diputado/1247
30,379,606,"ALARCIA, Martha Carmen",84,61,2,118,265,https://votaciones.hcdn.gob.ar/diputado/606
31,584,607,"ALARCON, María del Carmen",304,78,36,445,863,https://votaciones.hcdn.gob.ar/diputado/607
32,8,1311,"ALBAMONTE, Alberto Gustavo",69,13,4,25,111,https://votaciones.hcdn.gob.ar/diputado/1311
33,1036,177,"ALBARRACIN, Jorge Luis",226,126,10,128,490,https://votaciones.hcdn.gob.ar/diputado/177
34,9,1248,"ALBERTI, Juan Carlos",36,19,3,53,111,https://votaciones.hcdn.gob.ar/diputado/1248
35,1430,570,"ALBORNOZ, Gabriela Romina",258,38,1,10,307,https://votaciones.hcdn.gob.ar/diputado/570
36,1157,36,"ALBRIEU, Oscar Edmundo Nicolas",284,19,1,19,323,https://votaciones.hcdn.gob.ar/diputado/36
37,496,609,"ALBRISI, César Alfredo",130,100,12,144,386,https://votaciones.hcdn.gob.ar/diputado/609
38,10,1199,"ALCALA, Nestor Ricardo",75,17,1,18,111,https://votaciones.hcdn.gob.ar/diputado/1199
39,585,610,"ALCHOURON, Guillermo Eduardo",255,171,40,397,863,https://votaciones.hcdn.gob.ar/diputado/610
40,1037,39,"ALCUAZ, Horacio Alberto",166,105,9,85,365,https://votaciones.hcdn.gob.ar/diputado/39
41,1338,64,"ALEGRE, Gilberto Oscar",300,38,28,124,490,https://votaciones.hcdn.gob.ar/diputado/64
42,11,1249,"ALENDE, Oscar Eduardo",7,3,1,134,145,https://votaciones.hcdn.gob.ar/diputado/1249
43,586,611,"ALESANDRI, Carlos Tomas",50,42,1,72,165,https://votaciones.hcdn.gob.ar/diputado/611
44,380,612,"ALESSANDRO, Dario Pedro",159,62,16,28,265,https://votaciones.hcdn.gob.ar/diputado/612
45,1038,233,"ALFARO, Germán Enrique",237,29,1,89,356,https://votaciones.hcdn.gob.ar/diputado/233
46,1158,77,"ALFONSÍN, Ricardo",357,143,13,300,813,https://votaciones.hcdn.gob.ar/diputado/77
47,12,1250,"ALGABA, Ernesto Pedro",34,54,5,18,111,https://votaciones.hcdn.gob.ar/diputado/1250
48,1159,43,"ALIZEGUI, Antonio Aníbal",66,20,1,12,99,https://votaciones.hcdn.gob.ar/diputado/43
49,692,614,"ALLENDE IRIARTE, Alberto",14,12,1,15,42,https://votaciones.hcdn.gob.ar/diputado/614
50,381,613,"ALLENDE, Alfredo Estanislao",101,53,1,110,265,https://votaciones.hcdn.gob.ar/diputado/613
51,1552,1653,"ALLENDE, Walberto Enrique",139,11,4,14,168,https://votaciones.hcdn.gob.ar/diputado/1653
52,819,38,"ALONSO, Gumersindo Federico",500,89,22,410,1021,https://votaciones.hcdn.gob.ar/diputado/38
53,1431,90,"ALONSO, Horacio Fernando",280,12,1,14,307,https://votaciones.hcdn.gob.ar/diputado/90
54,1160,552,"ALONSO, Laura",146,126,8,226,506,https://votaciones.hcdn.gob.ar/diputado/552
55,1553,1643,"ALONSO, Laura Valeria",94,42,4,28,168,https://votaciones.hcdn.gob.ar/diputado/1643
56,1248,585,"ALONSO, María Luz",393,6,0,8,407,https://votaciones.hcdn.gob.ar/diputado/585
57,13,1243,"ALSOGARAY, Albaro Carlos",53,50,8,100,211,https://votaciones.hcdn.gob.ar/diputado/1243
58,382,1498,"ALTERACH, Miguel Angel",65,24,1,10,100,https://votaciones.hcdn.gob.ar/diputado/1498
59,1554,1624,"ALUME SBODIO, Karim Augusto",81,35,7,45,168,https://votaciones.hcdn.gob.ar/diputado/1624
60,14,1314,"ALVAREZ ECHAGUE, Raul A.",91,25,3,92,211,https://votaciones.hcdn.gob.ar/diputado/1314
61,15,1251,"ALVAREZ GARCIA, Normando",69,45,5,92,211,https://votaciones.hcdn.gob.ar/diputado/1251
62,16,1312,"ALVAREZ, Carlos Alberto",67,55,2,87,211,https://votaciones.hcdn.gob.ar/diputado/1312
63,17,1417,"ALVAREZ, Carlos Raúl",92,20,3,49,164,https://votaciones.hcdn.gob.ar/diputado/1417
64,1161,453,"ALVAREZ, Elsa María",183,87,5,48,323,https://votaciones.hcdn.gob.ar/diputado/453
65,263,1313,"ALVAREZ, Hector Claudio",5,1,0,8,14,https://votaciones.hcdn.gob.ar/diputado/1313
66,1162,132,"ALVAREZ, Jorge Mario",159,85,11,68,323,https://votaciones.hcdn.gob.ar/diputado/132
67,820,115,"ALVAREZ, Juan José",327,121,20,595,1063,https://votaciones.hcdn.gob.ar/diputado/115
68,717,615,"ALVAREZ, Roque Tobías",160,22,3,28,213,https://votaciones.hcdn.gob.ar/diputado/615
69,1039,12,"ALVARO, Héctor Jorge",291,28,6,40,365,https://votaciones.hcdn.gob.ar/diputado/12
70,18,342,"AMADEO, Eduardo Pablo",460,184,6,185,835,https://votaciones.hcdn.gob.ar/diputado/342
71,1040,617,"AMENTA, Marcelo Eduardo",85,58,1,122,266,https://votaciones.hcdn.gob.ar/diputado/617
72,718,618,"AMSTUTZ, Guillermo",167,11,3,32,213,https://votaciones.hcdn.gob.ar/diputado/618
73,1141,619,"ANAUATE, Carlos Alfredo",3,1,0,114,118,https://votaciones.hcdn.gob.ar/diputado/619
74,817,620,"ANCARANI, Hilda Norma",0,0,0,1,1,https://votaciones.hcdn.gob.ar/diputado/620
75,1555,1627,"ANSALONI, Pablo Miguel",102,55,0,11,168,https://votaciones.hcdn.gob.ar/diputado/1627
76,19,1413,"ANTELO, José María",37,27,12,34,110,https://votaciones.hcdn.gob.ar/diputado/1413
77,1249,316,"ARAGON, Santiago",14,0,0,0,14,https://votaciones.hcdn.gob.ar/diputado/316
78,20,1415,"ARAGONES de JUAREZ, Mercedes",40,11,0,144,195,https://votaciones.hcdn.gob.ar/diputado/1415
79,383,1544,"ARAMBURU, Guillermo Raul",39,30,1,30,100,https://votaciones.hcdn.gob.ar/diputado/1544
80,21,1200,"ARANDA, Saturnino Dantti",78,13,0,20,111,https://votaciones.hcdn.gob.ar/diputado/1200
81,1041,63,"ARBO, José Ameghino",122,61,12,170,365,https://votaciones.hcdn.gob.ar/diputado/63
82,1556,1622,"ARCE, Mario Horacio",107,58,0,3,168,https://votaciones.hcdn.gob.ar/diputado/1622
83,1042,621,"ARDID, Mario Rolando",248,68,12,98,426,https://votaciones.hcdn.gob.ar/diputado/621
84,1163,506,"ARENA, Celia Isabel",286,10,1,26,323,https://votaciones.hcdn.gob.ar/diputado/506
85,1339,429,"ARENAS, Berta Hortensia",291,61,18,120,490,https://votaciones.hcdn.gob.ar/diputado/429
86,1043,407,"ARETA, María Josefa",199,32,5,129,365,https://votaciones.hcdn.gob.ar/diputado/407
87,587,623,"ARGUL, Marta del Carmen",86,41,7,31,165,https://votaciones.hcdn.gob.ar/diputado/623
88,1164,344,"ARGUMEDO, Alcira Susana",368,229,53,163,813,https://votaciones.hcdn.gob.ar/diputado/344
89,22,622,"ARGÜELLO, Jorge",452,31,17,181,681,https://votaciones.hcdn.gob.ar/diputado/622
90,1044,193,"ARGÜELLO, Octavio",258,18,1,88,365,https://votaciones.hcdn.gob.ar/diputado/193
91,23,1201,"ARIAS, Cesar",138,30,5,38,211,https://votaciones.hcdn.gob.ar/diputado/1201
92,24,1315,"ARMENDARIZ, Alejandro",45,31,2,33,111,https://votaciones.hcdn.gob.ar/diputado/1315
93,588,624,"ARNALDI, Monica Susana",77,52,0,36,165,https://votaciones.hcdn.gob.ar/diputado/624
94,821,625,"ARNOLD, Eduardo Ariel",285,16,9,388,698,https://votaciones.hcdn.gob.ar/diputado/625
95,25,1316,"ARRECHEA, José Salvador",74,11,3,23,111,https://votaciones.hcdn.gob.ar/diputado/1316
96,1250,368,"ARREGUI, Andrés Roberto",378,6,2,21,407,https://votaciones.hcdn.gob.ar/diputado/368
97,932,626,"ARRIAGA, Julio Esteban",551,57,2,222,832,https://votaciones.hcdn.gob.ar/diputado/626
98,1432,238,"ARRIETA, Gustavo Héctor",77,91,2,137,307,https://votaciones.hcdn.gob.ar/diputado/238
99,1557,1648,"ARROYO, Daniel Fernando",119,31,11,7,168,https://votaciones.hcdn.gob.ar/diputado/1648
100,822,627,"ARTOLA, Isabel Amanda",389,53,14,137,593,https://votaciones.hcdn.gob.ar/diputado/627
101,1165,245,"ASEF, Daniel Edgardo",65,3,0,28,96,https://votaciones.hcdn.gob.ar/diputado/245
102,1646,1716,"ASENCIO, Fernando",56,15,4,8,83,https://votaciones.hcdn.gob.ar/diputado/1716
103,1166,150,"ASPIAZU, Lucio Bernardo",90,60,1,172,323,https://votaciones.hcdn.gob.ar/diputado/150
104,1251,3,"ASSEFF, Alberto Emilio",45,60,23,279,407,https://votaciones.hcdn.gob.ar/diputado/3
105,384,48,"ATANASOF, Alfredo Néstor",552,145,16,492,1205,https://votaciones.hcdn.gob.ar/diputado/48
106,488,1708,"AUAD, Oscar Said",1,8,1,0,10,https://votaciones.hcdn.gob.ar/diputado/1708
107,497,1545,"AUBIA, Jorge Eduardo",13,6,0,14,33,https://votaciones.hcdn.gob.ar/diputado/1545
108,933,628,"AUGSBURGER, Silvia",493,164,26,149,832,https://votaciones.hcdn.gob.ar/diputado/628
109,1433,594,"AUSTIN, Brenda Lis",362,88,4,16,470,https://votaciones.hcdn.gob.ar/diputado/594
110,693,1191,"AVALOS ROBLES, Edmundo Eduardo",2,11,1,1,15,https://votaciones.hcdn.gob.ar/diputado/1191
111,498,1546,"AVELIN de GINESTAR, Nancy B.",8,13,0,12,33,https://votaciones.hcdn.gob.ar/diputado/1546
112,385,1547,"AVILA, Eduardo Carlos",52,17,1,30,100,https://votaciones.hcdn.gob.ar/diputado/1547
113,1252,188,"AVOSCAN, Herman Horacio",387,7,2,11,407,https://votaciones.hcdn.gob.ar/diputado/188
114,1559,1612,"AYALA, Aida Beatriz Máxima",69,24,0,75,168,https://votaciones.hcdn.gob.ar/diputado/1612
115,264,629,"AYALA, Juan Carlos",75,49,0,65,189,https://votaciones.hcdn.gob.ar/diputado/629
116,26,1476,"AYALA, Susana Beatriz",83,12,0,11,106,https://votaciones.hcdn.gob.ar/diputado/1476
117,27,1416,"AYETZ, Liliana",41,39,7,77,164,https://votaciones.hcdn.gob.ar/diputado/1416
118,934,630,"AZCOITI, Pedro José",347,181,19,285,832,https://votaciones.hcdn.gob.ar/diputado/630
119,265,631,"BAGLINI, Raúl Eduardo",67,17,3,11,98,https://votaciones.hcdn.gob.ar/diputado/631
120,1560,1690,"BAHILLO, Juanjo",149,12,4,3,168,https://votaciones.hcdn.gob.ar/diputado/1690
121,823,632,"BAIGORRI, Guillermo Francisco",437,55,45,161,698,https://votaciones.hcdn.gob.ar/diputado/632
122,719,633,"BAIGORRIA, Miguel Angel",170,21,6,16,213,https://votaciones.hcdn.gob.ar/diputado/633
123,499,634,"BALADRON, Manuel Justo",752,100,23,287,1162,https://votaciones.hcdn.gob.ar/diputado/634
124,1434,445,"BALBO, Elva Susana",266,61,2,57,386,https://votaciones.hcdn.gob.ar/diputado/445
125,1253,403,"BALCEDO, María Ester",371,7,0,29,407,https://votaciones.hcdn.gob.ar/diputado/403
126,1340,241,"BALDASSI, Héctor Walter",417,154,16,71,658,https://votaciones.hcdn.gob.ar/diputado/241
127,1045,417,"BALDATA, Griselda Angela",144,93,6,122,365,https://votaciones.hcdn.gob.ar/diputado/417
128,28,635,"BALESTRA, René Helvecio",103,70,6,49,228,https://votaciones.hcdn.gob.ar/diputado/635
129,29,636,"BALESTRINI, Alberto",77,15,2,230,324,https://votaciones.hcdn.gob.ar/diputado/636
130,30,1317,"BALESTRINI, Miguel Alberto",87,13,3,75,178,https://votaciones.hcdn.gob.ar/diputado/1317
131,589,637,"BALIAN, Alejandro",72,19,1,73,165,https://votaciones.hcdn.gob.ar/diputado/637
132,31,638,"BALTER, Carlos Mario",118,94,14,55,281,https://votaciones.hcdn.gob.ar/diputado/638
133,720,639,"BALTUZZI, Angel Enzo",171,15,14,13,213,https://votaciones.hcdn.gob.ar/diputado/639
134,1435,545,"BANFI, Karina Verónica",369,99,3,4,475,https://votaciones.hcdn.gob.ar/diputado/545
135,386,1532,"BANZAS de MOREAU, María del Cármen",32,29,1,38,100,https://votaciones.hcdn.gob.ar/diputado/1532
136,935,640,"BARAGIOLA, Vilma Rosana",158,79,6,589,832,https://votaciones.hcdn.gob.ar/diputado/640
137,694,641,"BARBAGELATA, María Elena",36,114,13,38,201,https://votaciones.hcdn.gob.ar/diputado/641
138,32,1203,"BARBERA, Eliseo",87,11,0,13,111,https://votaciones.hcdn.gob.ar/diputado/1203
139,387,1548,"BARBERIS, Edgardo Angel",31,20,3,46,100,https://votaciones.hcdn.gob.ar/diputado/1548
140,1167,157,"BARBIERI, Mario Leandro",120,58,2,143,323,https://votaciones.hcdn.gob.ar/diputado/157
141,33,1318,"BARBOTTI, Atilio",46,7,0,58,111,https://votaciones.hcdn.gob.ar/diputado/1318
142,1254,67,"BARCHETTA, Omar Segundo",164,94,26,123,407,https://votaciones.hcdn.gob.ar/diputado/67
143,1341,181,"BARDEGGIA, Luis María",318,92,9,71,490,https://votaciones.hcdn.gob.ar/diputado/181
144,1342,104,"BARLETTA, Mario Domingo",271,76,9,134,490,https://votaciones.hcdn.gob.ar/diputado/104
145,1168,19,"BARRANDEGUY, Raúl Enrique",277,25,3,18,323,https://votaciones.hcdn.gob.ar/diputado/19
146,1343,323,"BARRETO, Jorge Rubén",234,56,1,199,490,https://votaciones.hcdn.gob.ar/diputado/323
147,34,1477,"BARRIONUEVO, Eduardo Ernesto",95,15,13,41,164,https://votaciones.hcdn.gob.ar/diputado/1477
148,936,642,"BARRIONUEVO, José Luis",136,24,9,663,832,https://votaciones.hcdn.gob.ar/diputado/642
149,388,1533,"BARRIOS ARRECHEA, Ricardo A.",41,29,2,28,100,https://votaciones.hcdn.gob.ar/diputado/1533
150,389,1499,"BARRIOS, Luis Américo",53,22,2,23,100,https://votaciones.hcdn.gob.ar/diputado/1499
151,1046,37,"BARRIOS, Miguel Angel",242,98,7,18,365,https://votaciones.hcdn.gob.ar/diputado/37
152,1149,643,"BARTOLUCCI, Gilda Liliana",32,17,2,49,100,https://votaciones.hcdn.gob.ar/diputado/643
153,721,644,"BASILE, Daniel Armando",86,16,17,94,213,https://votaciones.hcdn.gob.ar/diputado/644
154,266,1252,"BASSANI, Angel Marcelo",2,5,0,7,14,https://votaciones.hcdn.gob.ar/diputado/1252
155,722,180,"BASTEIRO, Sergio Ariel",327,102,38,111,578,https://votaciones.hcdn.gob.ar/diputado/180
156,1255,360,"BASTERRA, Luis Eugenio",642,157,8,75,882,https://votaciones.hcdn.gob.ar/diputado/360
157,723,645,"BASUALDO, Roberto",160,15,17,21,213,https://votaciones.hcdn.gob.ar/diputado/645
158,35,1319,"BAUM, Daniel",72,17,0,22,111,https://votaciones.hcdn.gob.ar/diputado/1319
159,267,646,"BAYLAC, Juan Pablo",129,55,6,89,279,https://votaciones.hcdn.gob.ar/diputado/646
160,724,647,"BAYONZO, Liliana Amelia",433,242,18,352,1045,https://votaciones.hcdn.gob.ar/diputado/647
161,1256,110,"BAZZE, Miguel Ángel",512,239,11,120,882,https://votaciones.hcdn.gob.ar/diputado/110
162,824,648,"BECCANI, Alberto Juan",367,200,12,119,698,https://votaciones.hcdn.gob.ar/diputado/648
163,36,1320,"BECERRA, Carlos Armando",86,62,1,62,211,https://votaciones.hcdn.gob.ar/diputado/1320
164,37,1253,"BECERRA, Nicolas Eduardo",69,15,1,26,111,https://votaciones.hcdn.gob.ar/diputado/1253
165,590,649,"BECERRA, Omar Enrique",65,56,4,40,165,https://votaciones.hcdn.gob.ar/diputado/649
166,1047,468,"BEDANO, Nora Esther",583,27,6,156,772,https://votaciones.hcdn.gob.ar/diputado/468
167,825,650,"BEJARANO, Mario Fernando",298,14,9,377,698,https://votaciones.hcdn.gob.ar/diputado/650
168,1550,275,"BELLOCQ, Gerardo Alberto",3,2,0,0,5,https://votaciones.hcdn.gob.ar/diputado/275
169,1048,463,"BELOUS, Nélida",220,51,22,72,365,https://votaciones.hcdn.gob.ar/diputado/463
170,268,1204,"BELTRAN, Carlos Roberto",12,2,0,0,14,https://votaciones.hcdn.gob.ar/diputado/1204
171,1049,475,"BENAS, Verónica Claudia",220,79,42,24,365,https://votaciones.hcdn.gob.ar/diputado/475
172,1169,112,"BENEDETTI, Atilio Francisco Salvador",270,143,4,74,491,https://votaciones.hcdn.gob.ar/diputado/112
173,38,1254,"BENEDETTI, Jorge Enrique",38,44,5,111,198,https://votaciones.hcdn.gob.ar/diputado/1254
174,39,1418,"BENZI, María Cristina",105,29,1,29,164,https://votaciones.hcdn.gob.ar/diputado/1418
175,688,1549,"BERCOFF, María Graciela",1,3,0,3,7,https://votaciones.hcdn.gob.ar/diputado/1549
176,1344,191,"BERGMAN, Sergio Alejandro",57,57,4,65,183,https://votaciones.hcdn.gob.ar/diputado/191
177,40,1321,"BERHONGARAY, Antonio Tomás",36,21,1,53,111,https://votaciones.hcdn.gob.ar/diputado/1321
178,269,1322,"BERICUA, Jorge",6,5,0,3,14,https://votaciones.hcdn.gob.ar/diputado/1322
179,1561,1632,"BERISSO, Hernán",101,57,1,9,168,https://votaciones.hcdn.gob.ar/diputado/1632
180,1436,27,"BERMEJO, Sixto Osvaldo",276,13,5,13,307,https://votaciones.hcdn.gob.ar/diputado/27
181,41,1205,"BERMUDEZ, María del Pilar",78,14,2,17,111,https://votaciones.hcdn.gob.ar/diputado/1205
182,1345,306,"BERNABEY, Ramón Ernesto",354,49,1,61,465,https://votaciones.hcdn.gob.ar/diputado/306
183,1170,457,"BERNAL, María Eugenia",288,25,2,8,323,https://votaciones.hcdn.gob.ar/diputado/457
184,1050,651,"BERNAZZA, Claudia Alicia",235,9,2,20,266,https://votaciones.hcdn.gob.ar/diputado/651
185,937,652,"BERRAUTE, Ana",768,37,8,19,832,https://votaciones.hcdn.gob.ar/diputado/652
186,938,507,"BERTOL, Paula María",452,274,30,399,1155,https://votaciones.hcdn.gob.ar/diputado/507
187,826,653,"BERTOLYOTTI, Delma Noemí",109,3,0,20,132,https://votaciones.hcdn.gob.ar/diputado/653
188,725,549,"BERTONE, Rosana Andrea",1124,78,18,148,1368,https://votaciones.hcdn.gob.ar/diputado/549
189,1437,430,"BESADA, Alicia Irma",257,38,1,11,307,https://votaciones.hcdn.gob.ar/diputado/430
190,1334,70,"BETTANIN, Juan Carlos",56,1,0,3,60,https://votaciones.hcdn.gob.ar/diputado/70
191,591,654,"BEVACQUA, Adriana Norma",15,41,0,28,84,https://votaciones.hcdn.gob.ar/diputado/654
192,1051,655,"BEVERAGGI, Margarita Beatriz",88,67,16,176,347,https://votaciones.hcdn.gob.ar/diputado/655
193,1438,194,"BEVILACQUA, Gustavo",314,45,21,95,475,https://votaciones.hcdn.gob.ar/diputado/194
194,372,656,"BIANCHI SILVESTRE, Marcela Alejandra",921,65,8,129,1123,https://votaciones.hcdn.gob.ar/diputado/656
195,1052,510,"BIANCHI, Ivana María",433,160,32,697,1322,https://votaciones.hcdn.gob.ar/diputado/510
196,1257,400,"BIANCHI, María del Carmen",374,8,1,24,407,https://votaciones.hcdn.gob.ar/diputado/400
197,939,657,"BIANCO, Lía Fabiola",715,56,3,58,832,https://votaciones.hcdn.gob.ar/diputado/657
198,390,1500,"BIANCULLI, Leticia",62,24,1,13,100,https://votaciones.hcdn.gob.ar/diputado/1500
199,1053,408,"BIDEGAIN, Gloria Mercedes",603,32,5,132,772,https://votaciones.hcdn.gob.ar/diputado/408
200,1258,207,"BIELLA CALVET, Bernardo José",130,97,9,171,407,https://votaciones.hcdn.gob.ar/diputado/207
201,940,658,"BIELSA, Rafael",163,14,5,311,493,https://votaciones.hcdn.gob.ar/diputado/658
202,592,659,"BIGLIERI, María Emilia",63,51,20,31,165,https://votaciones.hcdn.gob.ar/diputado/659
203,941,21,"BINNER, Hermes Juan",448,156,40,412,1056,https://votaciones.hcdn.gob.ar/diputado/21
204,42,1323,"BISCHOF, Enrique",33,5,0,73,111,https://votaciones.hcdn.gob.ar/diputado/1323
205,270,1255,"BISCIOTTI, Victorio Osvaldo",7,7,0,0,14,https://votaciones.hcdn.gob.ar/diputado/1255
206,942,661,"BISUTTI, Delia Beatriz",404,207,48,173,832,https://votaciones.hcdn.gob.ar/diputado/661
207,391,1595,"BIZZOTTO, Ileana",41,18,2,6,67,https://votaciones.hcdn.gob.ar/diputado/1595
208,1171,479,"BLANCO DE PERALTA, Blanca",132,61,3,127,323,https://votaciones.hcdn.gob.ar/diputado/479
209,726,662,"BLANCO, Jesus Abel",186,18,3,6,213,https://votaciones.hcdn.gob.ar/diputado/662
210,271,1324,"BLANCO, Oscar Alberto",5,1,0,8,14,https://votaciones.hcdn.gob.ar/diputado/1324
211,593,663,"BONACINA, Mario Hector",71,28,17,49,165,https://votaciones.hcdn.gob.ar/diputado/663
212,827,664,"BONACORSI, Juan Carlos",176,38,11,473,698,https://votaciones.hcdn.gob.ar/diputado/664
213,828,2,"BONASSO, Miguel Luis",311,68,7,677,1063,https://votaciones.hcdn.gob.ar/diputado/2
214,43,665,"BONINO, Miguel Angel",100,37,4,140,281,https://votaciones.hcdn.gob.ar/diputado/665
215,44,1419,"BONOMI, Silvia Mónica",25,48,1,90,164,https://votaciones.hcdn.gob.ar/diputado/1419
216,45,1206,"BORDA, Osvaldo",100,26,4,48,178,https://votaciones.hcdn.gob.ar/diputado/1206
217,392,666,"BORDENAVE, Marcela Antonia",100,76,13,76,265,https://votaciones.hcdn.gob.ar/diputado/666
218,272,1325,"BORDIN CAROSIO, Hugo Antonio",50,20,0,11,81,https://votaciones.hcdn.gob.ar/diputado/1325
219,700,667,"BORRELLI, Osvaldo Martín",7,7,4,4,22,https://votaciones.hcdn.gob.ar/diputado/667
220,829,147,"BORSANI, Luis Gustavo",580,257,15,321,1173,https://votaciones.hcdn.gob.ar/diputado/147
221,393,669,"BORTOLOZZI de BOGADO, Adriana Raquel",188,34,7,48,277,https://votaciones.hcdn.gob.ar/diputado/669
222,830,670,"BOSCH, Irene Miriam",545,61,18,74,698,https://votaciones.hcdn.gob.ar/diputado/670
223,831,671,"BOSSA, Mauricio",55,56,9,36,156,https://votaciones.hcdn.gob.ar/diputado/671
224,1439,329,"BOSSIO, Diego Luis",331,33,13,98,475,https://votaciones.hcdn.gob.ar/diputado/329
225,1346,519,"BOYADJIAN, Graciela Eunice",95,14,0,74,183,https://votaciones.hcdn.gob.ar/diputado/519
226,46,1207,"BRACCHI, Osvaldo Américo",83,21,1,6,111,https://votaciones.hcdn.gob.ar/diputado/1207
227,1647,1715,"BRAGAGNOLO, Sebastián",62,23,0,4,89,https://votaciones.hcdn.gob.ar/diputado/1715
228,1562,1611,"BRAMBILLA, Sofía",109,59,0,0,168,https://votaciones.hcdn.gob.ar/diputado/1611
229,47,1326,"BRANDA, Carlos Ernesto",86,13,1,11,111,https://votaciones.hcdn.gob.ar/diputado/1326
230,500,672,"BRANDONI, Adalberto Luis",65,22,2,28,117,https://votaciones.hcdn.gob.ar/diputado/672
231,48,673,"BRAVO, Alfredo Pedro",131,94,14,105,344,https://votaciones.hcdn.gob.ar/diputado/673
232,1259,488,"BRAWER, Mara",393,9,0,5,407,https://votaciones.hcdn.gob.ar/diputado/488
233,273,674,"BREARD, Noel Eugenio",86,85,24,32,227,https://votaciones.hcdn.gob.ar/diputado/674
234,1426,547,"BREGMAN, Myriam",63,125,15,24,227,https://votaciones.hcdn.gob.ar/diputado/547
235,49,1420,"BRESER, Adalberto Edgardo",82,20,1,61,164,https://votaciones.hcdn.gob.ar/diputado/1420
236,1440,544,"BREZZO, María Eugenia",256,11,6,34,307,https://votaciones.hcdn.gob.ar/diputado/544
237,943,75,"BRILLO, José Ricardo",570,114,12,459,1155,https://votaciones.hcdn.gob.ar/diputado/75
238,594,675,"BRIOZZO, Alberto Nicolas",104,26,1,11,142,https://votaciones.hcdn.gob.ar/diputado/675
239,1441,574,"BRITEZ, María Cristina",208,156,5,106,475,https://votaciones.hcdn.gob.ar/diputado/574
240,395,676,"BRITOS, Oraldo Norvel",109,39,1,116,265,https://votaciones.hcdn.gob.ar/diputado/676
241,1347,28,"BRIZUELA DEL MORAL, Eduardo Segundo",365,128,2,163,658,https://votaciones.hcdn.gob.ar/diputado/28
242,1260,541,"BRIZUELA Y DORIA DE CARA, Olga Inés",79,74,3,68,224,https://votaciones.hcdn.gob.ar/diputado/541
243,1261,354,"BROMBERG, Isaac Benjamín",271,4,1,131,407,https://votaciones.hcdn.gob.ar/diputado/354
244,274,1256,"BROOK, Mario Carlos",7,2,0,3,12,https://votaciones.hcdn.gob.ar/diputado/1256
245,727,59,"BROWN, Carlos Ramón",260,139,4,217,620,https://votaciones.hcdn.gob.ar/diputado/59
246,944,234,"BRUE, Daniel Agustín",689,47,26,393,1155,https://votaciones.hcdn.gob.ar/diputado/234
247,275,1327,"BRUNATI, Luis Pedro",2,1,0,11,14,https://votaciones.hcdn.gob.ar/diputado/1327
248,50,1421,"BRUNELLI, Naldo Raul Adalberto",79,21,20,44,164,https://votaciones.hcdn.gob.ar/diputado/1421
249,51,1257,"BRUZZO, Omar Obdulio",23,15,0,73,111,https://votaciones.hcdn.gob.ar/diputado/1257
250,1442,201,"BRÜGGE, Juan Fernando",377,25,15,58,475,https://votaciones.hcdn.gob.ar/diputado/201
251,1563,1703,"BUCCA, Eduardo",101,12,10,45,168,https://votaciones.hcdn.gob.ar/diputado/1703
252,595,678,"BUCCO, Jorge Luis",52,56,0,57,165,https://votaciones.hcdn.gob.ar/diputado/678
253,1443,237,"BUIL, Sergio Omar",353,100,1,21,475,https://votaciones.hcdn.gob.ar/diputado/237
254,1142,679,"BULACIO, Nancy Evangelina",21,3,1,43,68,https://votaciones.hcdn.gob.ar/diputado/679
255,396,1501,"BULACIO, Rafael Alfredo",53,16,4,27,100,https://votaciones.hcdn.gob.ar/diputado/1501
256,945,680,"BULLRICH, Esteban  José",313,154,21,389,877,https://votaciones.hcdn.gob.ar/diputado/680
257,52,438,"BULLRICH, Patricia",359,266,30,281,936,https://votaciones.hcdn.gob.ar/diputado/438
258,1348,542,"BURGOS, María Gabriela",465,159,13,21,658,https://votaciones.hcdn.gob.ar/diputado/542
259,1172,199,"BURYAILE, Ricardo",213,145,17,131,506,https://votaciones.hcdn.gob.ar/diputado/199
260,946,681,"BURZACO, Eugenio",255,135,18,424,832,https://votaciones.hcdn.gob.ar/diputado/681
261,53,1422,"BUSSI, Antonio Domingo",12,18,2,54,86,https://votaciones.hcdn.gob.ar/diputado/1422
262,501,682,"BUSSI, Ricardo Argentino",37,49,16,96,198,https://votaciones.hcdn.gob.ar/diputado/682
263,596,683,"BUSTI, Jorge Pedro",22,40,1,21,84,https://votaciones.hcdn.gob.ar/diputado/683
264,713,684,"BUZONNE, Augusto Cesar",2,0,0,0,2,https://votaciones.hcdn.gob.ar/diputado/684
265,701,1188,"BUZZONE, Ricardo Ancell",1,0,1,0,2,https://votaciones.hcdn.gob.ar/diputado/1188
266,397,685,"CABALLERO MARTIN, Carlos Aurelio",63,46,5,151,265,https://votaciones.hcdn.gob.ar/diputado/685
267,1349,265,"CABANDIÉ, Juan",379,150,10,119,658,https://votaciones.hcdn.gob.ar/diputado/265
268,54,1423,"CABIRON, Juan Carlos",49,65,0,50,164,https://votaciones.hcdn.gob.ar/diputado/1423
269,276,1328,"CABRERA, Gerardo",10,2,0,2,14,https://votaciones.hcdn.gob.ar/diputado/1328
270,832,686,"CACERES, Gladys Antonia",116,8,0,8,132,https://votaciones.hcdn.gob.ar/diputado/686
271,689,1551,"CACERES, Jorge Marcelo",1,0,0,1,2,https://votaciones.hcdn.gob.ar/diputado/1551
272,398,1534,"CAFFERATA NORES, José Ignacio",25,15,1,59,100,https://votaciones.hcdn.gob.ar/diputado/1534
273,277,688,"CAFIERO, Juan Pablo",90,36,3,45,174,https://votaciones.hcdn.gob.ar/diputado/688
274,502,687,"CAFIERO, Mario Alejandro",66,159,17,88,330,https://votaciones.hcdn.gob.ar/diputado/687
275,399,1552,"CAILLET, Carmen del Rosario",57,15,2,26,100,https://votaciones.hcdn.gob.ar/diputado/1552
276,55,1412,"CAIMMI, Fernando Enrique",5,2,0,28,35,https://votaciones.hcdn.gob.ar/diputado/1412
277,1262,257,"CALCAGNO Y MAILLMANN, Eric",395,8,1,3,407,https://votaciones.hcdn.gob.ar/diputado/257
278,1054,526,"CALCHAQUI, Mariel",287,30,3,45,365,https://votaciones.hcdn.gob.ar/diputado/526
279,56,1424,"CALLABA, Anibal",46,48,0,70,164,https://votaciones.hcdn.gob.ar/diputado/1424
280,278,1330,"CALLEJAS, Ovidio Amilcar",9,2,0,3,14,https://votaciones.hcdn.gob.ar/diputado/1330
281,1444,318,"CALLERI, Agustín Santiago",251,11,3,42,307,https://votaciones.hcdn.gob.ar/diputado/318
282,597,689,"CALVO, Pedro Jorge Camilo",95,29,5,36,165,https://votaciones.hcdn.gob.ar/diputado/689
283,1055,690,"CALZA, Nelio Higinio",211,9,1,45,266,https://votaciones.hcdn.gob.ar/diputado/690
284,57,1425,"CAMARA, Mario Miguel",92,21,1,50,164,https://votaciones.hcdn.gob.ar/diputado/1425
285,279,691,"CAMAÑO, Dante Alberto",87,29,5,623,744,https://votaciones.hcdn.gob.ar/diputado/691
286,58,692,"CAMAÑO, Eduardo Oscar",462,152,37,211,862,https://votaciones.hcdn.gob.ar/diputado/692
287,280,427,"CAMAÑO, Graciela",1024,202,71,774,2071,https://votaciones.hcdn.gob.ar/diputado/427
288,400,693,"CAMBARERI, Fortunato Rafael",291,159,20,490,960,https://votaciones.hcdn.gob.ar/diputado/693
289,1564,1638,"CAMPAGNOLI, Marcela",77,59,1,31,168,https://votaciones.hcdn.gob.ar/diputado/1638
290,59,1426,"CAMPERO, Rodolfo Martín",38,13,1,112,164,https://votaciones.hcdn.gob.ar/diputado/1426
291,1565,1662,"CAMPOS, Javier",76,60,4,28,168,https://votaciones.hcdn.gob.ar/diputado/1662
292,281,1331,"CANATA, José Domingo",4,1,0,9,14,https://votaciones.hcdn.gob.ar/diputado/1331
293,947,412,"CANELA, Susana",914,45,16,40,1015,https://votaciones.hcdn.gob.ar/diputado/412
294,728,695,"CANEVAROLO, Dante Omar",443,31,4,78,556,https://votaciones.hcdn.gob.ar/diputado/695
295,1351,243,"CANO, José Manuel",160,105,10,76,351,https://votaciones.hcdn.gob.ar/diputado/243
296,1566,1655,"CANTARD, Albor Angel",87,58,0,23,168,https://votaciones.hcdn.gob.ar/diputado/1655
297,948,697,"CANTERO GUTIERREZ, Alberto",732,38,3,59,832,https://votaciones.hcdn.gob.ar/diputado/697
298,702,696,"CANTERO, Fernando Alfredo",6,7,0,9,22,https://votaciones.hcdn.gob.ar/diputado/696
299,833,698,"CANTEROS, Gustavo Jesús Adolfo",347,24,3,302,676,https://votaciones.hcdn.gob.ar/diputado/698
300,729,699,"CANTINI, Guillermo Marcelo",79,81,4,49,213,https://votaciones.hcdn.gob.ar/diputado/699
301,834,700,"CANTOS, José María",498,34,3,163,698,https://votaciones.hcdn.gob.ar/diputado/700
302,598,701,"CAPELLO, Mario Osvaldo",110,37,2,16,165,https://votaciones.hcdn.gob.ar/diputado/701
303,730,702,"CAPPELLERI, Pascual",70,89,3,51,213,https://votaciones.hcdn.gob.ar/diputado/702
304,282,1332,"CAPUTO, Dante Mario",14,13,1,19,47,https://votaciones.hcdn.gob.ar/diputado/1332
305,1567,1649,"CARAMBIA, Antonio José",89,49,1,29,168,https://votaciones.hcdn.gob.ar/diputado/1649
306,401,1553,"CARBAJAL, Arnoldo Dante",18,16,0,66,100,https://votaciones.hcdn.gob.ar/diputado/1553
307,731,703,"CARBONETTO, Daniel",122,14,5,72,213,https://votaciones.hcdn.gob.ar/diputado/703
308,60,428,"CARCA, Elisa Beatriz",201,147,15,166,529,https://votaciones.hcdn.gob.ar/diputado/428
309,1173,54,"CARDELLI, Jorge Justo",115,66,15,127,323,https://votaciones.hcdn.gob.ar/diputado/54
310,503,704,"CARDESA, Enrique Gustavo",64,35,3,15,117,https://votaciones.hcdn.gob.ar/diputado/704
311,402,1502,"CARDOSO, Marta Elena",68,21,3,8,100,https://votaciones.hcdn.gob.ar/diputado/1502
312,949,205,"CARLOTTO, Remo Gerardo",1179,135,9,322,1645,https://votaciones.hcdn.gob.ar/diputado/205
313,1263,256,"CARMONA, Guillermo Ramón",605,168,15,94,882,https://votaciones.hcdn.gob.ar/diputado/256
314,950,705,"CARMONA, María Araceli",684,36,26,86,832,https://votaciones.hcdn.gob.ar/diputado/705
315,1445,583,"CAROL, Analuz Ailén",215,151,7,102,475,https://votaciones.hcdn.gob.ar/diputado/583
316,1174,352,"CARRANZA, Carlos Alberto",117,84,4,118,323,https://votaciones.hcdn.gob.ar/diputado/352
317,403,1503,"CARRARA, Emilio Eduardo",57,19,3,21,100,https://votaciones.hcdn.gob.ar/diputado/1503
318,283,1258,"CARRERAS, Porfirio Mario",7,6,0,1,14,https://votaciones.hcdn.gob.ar/diputado/1258
319,1335,491,"CARRILLO, María del Carmen",271,4,0,13,288,https://votaciones.hcdn.gob.ar/diputado/491
320,1352,508,"CARRIZO, Ana Carla",435,125,31,67,658,https://votaciones.hcdn.gob.ar/diputado/508
321,1353,569,"CARRIZO, Nilda Mabel",321,128,7,34,490,https://votaciones.hcdn.gob.ar/diputado/569
322,1354,561,"CARRIZO, Soledad",417,130,15,96,658,https://votaciones.hcdn.gob.ar/diputado/561
323,404,465,"CARRIÓ, Elisa María Avelina",317,234,38,1063,1652,https://votaciones.hcdn.gob.ar/diputado/465
324,1568,1686,"CARRO, Pablo",105,49,3,11,168,https://votaciones.hcdn.gob.ar/diputado/1686
325,732,706,"CASANOVAS, Jorge Osvaldo",90,25,1,97,213,https://votaciones.hcdn.gob.ar/diputado/706
326,61,1333,"CASARI de ALARCIA, Leonor",75,18,0,85,178,https://votaciones.hcdn.gob.ar/diputado/1333
327,1175,226,"CASAÑAS, Juan Francisco",243,108,4,458,813,https://votaciones.hcdn.gob.ar/diputado/226
328,504,1494,"CASELLA, Juan Manuel",32,15,0,8,55,https://votaciones.hcdn.gob.ar/diputado/1494
329,1056,520,"CASELLES, Graciela María",916,74,12,245,1247,https://votaciones.hcdn.gob.ar/diputado/520
330,835,62,"CASERIO, Carlos Alberto",437,44,4,396,881,https://votaciones.hcdn.gob.ar/diputado/62
331,836,708,"CASSESE, Marina",281,64,74,294,713,https://votaciones.hcdn.gob.ar/diputado/708
332,1569,1681,"CASSINERIO, Paulo Leonardo",131,14,4,19,168,https://votaciones.hcdn.gob.ar/diputado/1681
333,1446,172,"CASTAGNETO, Carlos Daniel",238,171,10,56,475,https://votaciones.hcdn.gob.ar/diputado/172
334,1150,389,"CASTALDO, Norah Susana",98,40,10,51,199,https://votaciones.hcdn.gob.ar/diputado/389
335,599,709,"CASTAÑON, Alfredo José",14,32,1,15,62,https://votaciones.hcdn.gob.ar/diputado/709
336,1176,174,"CASTAÑON, Hugo",103,69,1,150,323,https://votaciones.hcdn.gob.ar/diputado/174
337,600,710,"CASTELLANI, Carlos Alberto",42,55,3,65,165,https://votaciones.hcdn.gob.ar/diputado/710
338,62,1334,"CASTILLO, José Luis",126,28,2,55,211,https://votaciones.hcdn.gob.ar/diputado/1334
339,63,1259,"CASTILLO, Oscar Anibal",37,14,0,127,178,https://votaciones.hcdn.gob.ar/diputado/1259
340,1549,61,"CASTRO MOLINA, Enrique Roberto",9,1,0,1,11,https://votaciones.hcdn.gob.ar/diputado/61
341,505,711,"CASTRO, Alicia Amalia",71,119,12,128,330,https://votaciones.hcdn.gob.ar/diputado/711
342,64,1427,"CASTRO, Carlos José",101,24,4,35,164,https://votaciones.hcdn.gob.ar/diputado/1427
343,1355,584,"CASTRO, Sandra Daniela",454,160,21,23,658,https://votaciones.hcdn.gob.ar/diputado/584
344,1264,274,"CATALAN MAGNI, Julio César",218,4,0,2,224,https://votaciones.hcdn.gob.ar/diputado/274
345,951,712,"CAVADINI, Eduardo",200,5,19,337,561,https://votaciones.hcdn.gob.ar/diputado/712
346,284,1260,"CAVALLARI, Juan José",5,2,0,7,14,https://votaciones.hcdn.gob.ar/diputado/1260
347,601,713,"CAVALLERO, Hector José",71,53,4,37,165,https://votaciones.hcdn.gob.ar/diputado/713
348,506,714,"CAVALLO, Domingo Felipe",14,12,6,63,95,https://votaciones.hcdn.gob.ar/diputado/714
349,602,165,"CAVIGLIA, Franco Agustín",274,53,7,138,472,https://votaciones.hcdn.gob.ar/diputado/165
350,405,1555,"CEBALLOS de MARIN, Fani A.",31,13,0,56,100,https://votaciones.hcdn.gob.ar/diputado/1555
351,65,1261,"CEBALLOS, Walter Alberto",47,34,2,28,111,https://votaciones.hcdn.gob.ar/diputado/1261
352,837,716,"CECCO, Carlos Jaime",217,178,6,297,698,https://votaciones.hcdn.gob.ar/diputado/716
353,1057,88,"CEJAS, Jorge Alberto",686,36,6,44,772,https://votaciones.hcdn.gob.ar/diputado/88
354,921,717,"CERDAN, Argentina",24,1,0,17,42,https://votaciones.hcdn.gob.ar/diputado/717
355,66,1429,"CERDERA, Rogelio Rafael",38,5,0,54,97,https://votaciones.hcdn.gob.ar/diputado/1429
356,733,718,"CEREZO, Octavio Néstor",134,17,0,62,213,https://votaciones.hcdn.gob.ar/diputado/718
357,1570,1664,"CERRUTI, Gabriela",105,46,5,12,168,https://votaciones.hcdn.gob.ar/diputado/1664
358,952,719,"CESAR, Nora Noemí",608,27,22,175,832,https://votaciones.hcdn.gob.ar/diputado/719
359,734,720,"CETTOUR, Hugo Ramón",168,23,1,21,213,https://votaciones.hcdn.gob.ar/diputado/720
360,507,721,"CHAYA, María Lelia",47,56,2,225,330,https://votaciones.hcdn.gob.ar/diputado/721
361,1177,125,"CHEMES, Jorge Omar",130,74,4,115,323,https://votaciones.hcdn.gob.ar/diputado/125
362,695,722,"CHIACCHIO, Nora Alicia",572,84,12,170,838,https://votaciones.hcdn.gob.ar/diputado/722
363,406,1556,"CHICA RODRIGUEZ, Juan José",52,21,6,21,100,https://votaciones.hcdn.gob.ar/diputado/1556
364,1178,432,"CHIENO, María Elena",266,25,5,27,323,https://votaciones.hcdn.gob.ar/diputado/432
365,1058,396,"CHIQUICHANO, Rosa Laudelina",233,21,7,104,365,https://votaciones.hcdn.gob.ar/diputado/396
366,838,723,"CHIRONI, Fernando Gustavo",320,153,13,212,698,https://votaciones.hcdn.gob.ar/diputado/723
367,1265,100,"CIAMPINI, José Alberto",612,148,6,116,882,https://votaciones.hcdn.gob.ar/diputado/100
368,285,1208,"CICARE, Miguel Angel",7,3,0,4,14,https://votaciones.hcdn.gob.ar/diputado/1208
369,1179,444,"CICILIANI, Alicia Mabel",444,185,33,150,812,https://votaciones.hcdn.gob.ar/diputado/444
370,735,5,"CIGOGNA, Luis Francisco Jorge",1470,185,4,100,1759,https://votaciones.hcdn.gob.ar/diputado/5
371,736,724,"CISTERNA, Victor Hugo",141,25,2,45,213,https://votaciones.hcdn.gob.ar/diputado/724
372,839,725,"CITTADINI, Stella",587,29,3,79,698,https://votaciones.hcdn.gob.ar/diputado/725
373,1266,332,"CLERI, Marcos",603,152,9,118,882,https://votaciones.hcdn.gob.ar/diputado/332
374,1447,287,"CLOSS, Maurice Fabian",170,27,5,105,307,https://votaciones.hcdn.gob.ar/diputado/287
375,67,1428,"CLOSS, Ramón Alberto",55,40,1,68,164,https://votaciones.hcdn.gob.ar/diputado/1428
376,1356,107,"COBOS, Julio César Cleto",87,63,12,21,183,https://votaciones.hcdn.gob.ar/diputado/107
377,953,726,"COIRINI, Adriana Elsa",357,33,6,165,561,https://votaciones.hcdn.gob.ar/diputado/726
378,954,727,"COLLANTES, Genaro Aurelio",381,63,11,377,832,https://votaciones.hcdn.gob.ar/diputado/727
379,603,728,"COLOMBI, Ricardo",236,24,5,318,583,https://votaciones.hcdn.gob.ar/diputado/728
380,508,729,"COLOMBO, María Teresita del Valle",68,26,5,18,117,https://votaciones.hcdn.gob.ar/diputado/729
381,509,730,"COLUCIGNO, Aurelia Alicia",78,24,1,14,117,https://votaciones.hcdn.gob.ar/diputado/730
382,840,515,"COMELLI, Alicia Marcela",880,147,50,393,1470,https://votaciones.hcdn.gob.ar/diputado/515
383,1180,230,"COMI, Carlos Marcelo",119,75,6,123,323,https://votaciones.hcdn.gob.ar/diputado/230
384,604,731,"CONCA, Julio Cesar",96,30,26,13,165,https://votaciones.hcdn.gob.ar/diputado/731
385,1448,17,"CONESA, Eduardo Raúl",255,38,3,11,307,https://votaciones.hcdn.gob.ar/diputado/17
386,737,732,"CONTE  GRAND, Gerardo Amadeo",158,25,11,19,213,https://votaciones.hcdn.gob.ar/diputado/732
387,510,437,"CONTI, Diana Beatriz",1202,126,11,361,1700,https://votaciones.hcdn.gob.ar/diputado/437
388,1571,1614,"CONTIGIANI, Luis Gustavo",114,36,4,14,168,https://votaciones.hcdn.gob.ar/diputado/1614
389,1336,469,"CONTRERA, Mónica Graciela",262,3,0,23,288,https://votaciones.hcdn.gob.ar/diputado/469
390,1449,471,"COPES, Ana Isabel",260,40,6,1,307,https://votaciones.hcdn.gob.ar/diputado/471
391,68,733,"CORCHUELO BLASCO, José Manuel",163,63,5,64,295,https://votaciones.hcdn.gob.ar/diputado/733
392,511,734,"CORDOBA, José Manuel",570,27,9,227,833,https://votaciones.hcdn.gob.ar/diputado/734
393,738,414,"CORDOBA, Stella Maris",997,62,42,267,1368,https://votaciones.hcdn.gob.ar/diputado/414
394,605,735,"CORFIELD, Guillermo Eduardo",104,48,6,7,165,https://votaciones.hcdn.gob.ar/diputado/735
395,955,736,"CORNEJO, Alfredo Victor",144,51,16,355,566,https://votaciones.hcdn.gob.ar/diputado/736
396,703,738,"CORREA, Elsa Haydee",61,22,1,19,103,https://votaciones.hcdn.gob.ar/diputado/738
397,739,737,"CORREA, Juan Carlos",187,20,1,5,213,https://votaciones.hcdn.gob.ar/diputado/737
398,1572,1698,"CORREA, Walter",100,46,5,17,168,https://votaciones.hcdn.gob.ar/diputado/1698
399,1059,263,"CORTINA, Roy",290,180,20,282,772,https://votaciones.hcdn.gob.ar/diputado/263
400,606,739,"CORTINAS, Ismael Ramón",51,28,8,78,165,https://votaciones.hcdn.gob.ar/diputado/739
401,956,740,"COSCIA, Jorge Edmundo",598,32,6,96,732,https://votaciones.hcdn.gob.ar/diputado/740
402,286,1335,"COSSOS PEREZ, Juan Nicolás",3,5,0,6,14,https://votaciones.hcdn.gob.ar/diputado/1335
403,1181,187,"COSTA, Eduardo Raúl",319,124,13,357,813,https://votaciones.hcdn.gob.ar/diputado/187
404,841,741,"COSTA, Roberto Raúl",125,61,21,491,698,https://votaciones.hcdn.gob.ar/diputado/741
405,740,742,"COTO, Alberto Agustín",178,21,2,12,213,https://votaciones.hcdn.gob.ar/diputado/742
406,1644,1181,"COULY, Veronica Carolina",45,3,2,67,117,https://votaciones.hcdn.gob.ar/diputado/1181
407,607,743,"COUREL, Carlos Alberto",85,35,10,35,165,https://votaciones.hcdn.gob.ar/diputado/743
408,1450,343,"COUSINET, Graciela",187,62,8,50,307,https://votaciones.hcdn.gob.ar/diputado/343
409,287,1336,"CRAMARO, Hugo Arnaldo",3,0,0,11,14,https://votaciones.hcdn.gob.ar/diputado/1336
410,1060,399,"CREMER DE BUSTI, María Cristina",637,144,44,254,1079,https://votaciones.hcdn.gob.ar/diputado/399
411,1573,1673,"CRESTO, Mayda",135,14,3,16,168,https://votaciones.hcdn.gob.ar/diputado/1673
412,69,1209,"CROSTELLI, Juan Carlos",83,17,4,7,111,https://votaciones.hcdn.gob.ar/diputado/1209
413,407,1193,"CRUCHAGA, Melchor René",84,40,2,36,162,https://votaciones.hcdn.gob.ar/diputado/1193
414,288,1210,"CRUZ, Washington Jesus",8,0,1,5,14,https://votaciones.hcdn.gob.ar/diputado/1210
415,1061,73,"CUCCOVILLO, Ricardo Oscar",307,195,14,256,772,https://votaciones.hcdn.gob.ar/diputado/73
416,957,744,"CUEVAS, Hugo Oscar",554,102,19,157,832,https://votaciones.hcdn.gob.ar/diputado/744
417,512,745,"CURLETTI, Miriam Belén",64,23,0,30,117,https://votaciones.hcdn.gob.ar/diputado/745
418,1182,126,"CURRILEN, Oscar Rubén",291,9,1,22,323,https://votaciones.hcdn.gob.ar/diputado/126
419,741,121,"CUSINATO, Gustavo",232,160,13,173,578,https://votaciones.hcdn.gob.ar/diputado/121
420,1350,312,"CÁCERES, Eduardo Augusto",386,163,12,97,658,https://votaciones.hcdn.gob.ar/diputado/312
421,1357,140,"D'AGOSTINO, Jorge Marcelo",303,105,14,68,490,https://votaciones.hcdn.gob.ar/diputado/140
422,1358,311,"D'ALESSANDRO, Marcelo Silvio",64,26,4,89,183,https://votaciones.hcdn.gob.ar/diputado/311
423,70,1337,"D'ALESSANDRO, Miguel H.",79,9,4,19,111,https://votaciones.hcdn.gob.ar/diputado/1337
424,71,1262,"D'AMBROSIO, Angel Mario",29,30,2,50,111,https://votaciones.hcdn.gob.ar/diputado/1262
425,72,1430,"D'ELIA, Roberto Antonio",66,78,3,17,164,https://votaciones.hcdn.gob.ar/diputado/1430
426,1359,185,"DAER, Héctor Ricardo",171,28,13,278,490,https://votaciones.hcdn.gob.ar/diputado/185
427,608,415,"DAHER, Zulema Beatríz",729,159,24,316,1228,https://votaciones.hcdn.gob.ar/diputado/415
428,958,747,"DALLA FONTANA, Ariel  Raúl Armando",521,59,72,175,827,https://votaciones.hcdn.gob.ar/diputado/747
429,742,748,"DAMIANI, Hernán Norberto Luis",63,79,5,66,213,https://votaciones.hcdn.gob.ar/diputado/748
430,1062,478,"DAMILANO GRIVARELLO, Viviana Mónica",303,30,4,28,365,https://votaciones.hcdn.gob.ar/diputado/478
431,408,72,"DAS NEVES, Mario",139,75,25,130,369,https://votaciones.hcdn.gob.ar/diputado/72
432,1063,346,"DATO, Alfredo Carlos",677,39,0,56,772,https://votaciones.hcdn.gob.ar/diputado/346
433,73,750,"DAUD, Jorge Carlos",615,55,9,211,890,https://votaciones.hcdn.gob.ar/diputado/750
434,1451,296,"DAVID, Javier",375,37,12,51,475,https://votaciones.hcdn.gob.ar/diputado/296
435,842,751,"DAZA, Héctor Rubén",442,29,17,210,698,https://votaciones.hcdn.gob.ar/diputado/751
436,609,752,"DE BALDRICH, Jorge Amadeo",18,34,2,8,62,https://votaciones.hcdn.gob.ar/diputado/752
437,514,753,"DE BARIAZARRA, Roberto Rodolfo",65,30,4,18,117,https://votaciones.hcdn.gob.ar/diputado/753
438,843,754,"DE BERNARDI, Eduardo",539,38,9,112,698,https://votaciones.hcdn.gob.ar/diputado/754
439,844,755,"DE BRASI, Marta Susana",325,67,26,280,698,https://votaciones.hcdn.gob.ar/diputado/755
440,1267,439,"DE FERRARI RUEDA, Patricia",168,137,14,88,407,https://votaciones.hcdn.gob.ar/diputado/439
441,1268,23,"DE GENNARO, Victor Norberto",123,74,17,193,407,https://votaciones.hcdn.gob.ar/diputado/23
442,845,756,"DE LA BARRERA, Guillermo",548,39,5,106,698,https://votaciones.hcdn.gob.ar/diputado/756
443,846,355,"DE LA ROSA, Maria Graciela",928,78,4,53,1063,https://votaciones.hcdn.gob.ar/diputado/355
444,847,757,"DE LAJONQUIERE, Nelson",27,38,2,65,132,https://votaciones.hcdn.gob.ar/diputado/757
445,959,247,"DE MARCHI, Omar Bruno",312,263,35,545,1155,https://votaciones.hcdn.gob.ar/diputado/247
446,289,1263,"DE MARTINO, Victor Amador",6,4,0,4,14,https://votaciones.hcdn.gob.ar/diputado/1263
447,1360,65,"DE MENDIGUREN, José Ignacio",347,56,35,220,658,https://votaciones.hcdn.gob.ar/diputado/65
448,960,264,"DE NARVAEZ, Francisco",275,191,24,848,1338,https://votaciones.hcdn.gob.ar/diputado/264
449,743,758,"DE NUCCIO, Fabián",42,106,22,43,213,https://votaciones.hcdn.gob.ar/diputado/758
450,690,1536,"DE PAULA, Victor Francisco",0,2,0,0,2,https://votaciones.hcdn.gob.ar/diputado/1536
451,1269,378,"DE PEDRO, Eduardo Enrique",530,162,11,125,828,https://votaciones.hcdn.gob.ar/diputado/378
452,1452,587,"DE PONTI, Lucila María",211,132,7,125,475,https://votaciones.hcdn.gob.ar/diputado/587
453,1183,246,"DE PRAT GAY, Alfonso",112,67,13,131,323,https://votaciones.hcdn.gob.ar/diputado/246
454,515,759,"DE SANCTIS, Guillermo Horacio",41,45,0,31,117,https://votaciones.hcdn.gob.ar/diputado/759
455,1453,58,"DE VIDO, Julio (Suspendido Art 70 C.N.)",77,49,2,347,475,https://votaciones.hcdn.gob.ar/diputado/58
456,961,760,"DEL  RICCIO, Ana María del Carmen",76,2,0,25,103,https://votaciones.hcdn.gob.ar/diputado/760
457,1064,203,"DEL CAMPILLO, Héctor Eduardo",151,76,7,131,365,https://votaciones.hcdn.gob.ar/diputado/203
458,579,1604,"DEL CASTILLO, Fernando Raul",1,3,0,7,11,https://votaciones.hcdn.gob.ar/diputado/1604
459,1361,331,"DEL CAÑO, Nicolás",133,114,43,61,351,https://votaciones.hcdn.gob.ar/diputado/331
460,74,1431,"DEL FABRO, Lilian del Carmen",44,57,1,62,164,https://votaciones.hcdn.gob.ar/diputado/1431
461,516,1537,"DELICH, Andrés Guillermo",6,8,0,19,33,https://votaciones.hcdn.gob.ar/diputado/1537
462,962,761,"DELICH, Francisco José",456,42,34,300,832,https://votaciones.hcdn.gob.ar/diputado/761
463,75,762,"DELLEPIANE, Carlos Francisco",300,116,38,408,862,https://votaciones.hcdn.gob.ar/diputado/762
464,1576,1676,"DELÚ, Melina Aida",130,11,5,22,168,https://votaciones.hcdn.gob.ar/diputado/1676
465,963,167,"DEPETRI, Edgardo Fernando",847,114,6,627,1594,https://votaciones.hcdn.gob.ar/diputado/167
466,1577,1683,"DERNA, Verónica",143,14,3,8,168,https://votaciones.hcdn.gob.ar/diputado/1683
467,744,763,"DI BENEDETTO, Gustavo Daniel",65,101,3,44,213,https://votaciones.hcdn.gob.ar/diputado/763
468,610,764,"DI COLA, Eduardo Román",79,43,1,42,165,https://votaciones.hcdn.gob.ar/diputado/764
469,848,765,"DI LANDRO, Oscar Jorge",454,39,6,199,698,https://votaciones.hcdn.gob.ar/diputado/765
470,611,766,"DI LEO, Marta Isabel",99,44,6,16,165,https://votaciones.hcdn.gob.ar/diputado/766
471,849,767,"DI POLLINA, Eduardo Alfredo",327,175,32,164,698,https://votaciones.hcdn.gob.ar/diputado/767
472,1454,340,"DI STÉFANO, Daniel",227,99,3,146,475,https://votaciones.hcdn.gob.ar/diputado/340
473,76,1264,"DI TULIO, Hector Horacio",29,26,2,54,111,https://votaciones.hcdn.gob.ar/diputado/1264
474,612,7,"DIAZ BANCALARI, José María",1343,146,11,135,1635,https://votaciones.hcdn.gob.ar/diputado/7
475,613,768,"DIAZ COLODRERO, Agustín",16,23,2,92,133,https://votaciones.hcdn.gob.ar/diputado/768
476,517,769,"DIAZ COLODRERO, Luis María",47,35,4,31,117,https://votaciones.hcdn.gob.ar/diputado/769
477,409,1504,"DIAZ LOZANO, Julio César",44,13,3,40,100,https://votaciones.hcdn.gob.ar/diputado/1504
478,77,1432,"DIAZ MARTINEZ, Jorge Raúl",86,21,3,54,164,https://votaciones.hcdn.gob.ar/diputado/1432
479,965,137,"DIAZ ROIG, Juan Carlos",1135,183,9,318,1645,https://votaciones.hcdn.gob.ar/diputado/137
480,850,426,"DIAZ, Susana Eladia",757,67,24,206,1054,https://votaciones.hcdn.gob.ar/diputado/426
481,1065,770,"DIEZ, María Inés",167,36,7,78,288,https://votaciones.hcdn.gob.ar/diputado/770
482,78,1591,"DIGON, Roberto",98,16,7,43,164,https://votaciones.hcdn.gob.ar/diputado/1591
483,1455,184,"DINDART, Julián",296,92,4,83,475,https://votaciones.hcdn.gob.ar/diputado/184
484,851,771,"DOGA, María Nélida",198,32,31,437,698,https://votaciones.hcdn.gob.ar/diputado/771
485,410,1505,"DOMINA, Esteban Alberto",65,22,0,13,100,https://votaciones.hcdn.gob.ar/diputado/1505
486,411,1557,"DOMINGUEZ, Dolores Carmen",60,21,1,18,100,https://votaciones.hcdn.gob.ar/diputado/1557
487,1270,209,"DOMINGUEZ, Julián Andrés",62,1,0,40,103,https://votaciones.hcdn.gob.ar/diputado/209
488,412,1506,"DOMINGUEZ, Lorenzo Sebastián",65,25,1,9,100,https://votaciones.hcdn.gob.ar/diputado/1506
489,1645,1183,"DOMINGUEZ, Ramon Alfredo",39,5,2,36,82,https://votaciones.hcdn.gob.ar/diputado/1183
490,580,1592,"DOMSIC, Lidia Catalina",20,4,0,1,25,https://votaciones.hcdn.gob.ar/diputado/1592
491,1066,524,"DONDA PÉREZ, Victoria Analía",535,193,49,470,1247,https://votaciones.hcdn.gob.ar/diputado/524
492,1184,74,"DONKIN, Carlos Guillermo",431,12,2,10,455,https://votaciones.hcdn.gob.ar/diputado/74
493,373,1489,"DONNI, Luisa Cristina",59,12,1,4,76,https://votaciones.hcdn.gob.ar/diputado/1489
494,966,772,"DOVENA, Miguel Dante",640,28,15,149,832,https://votaciones.hcdn.gob.ar/diputado/772
495,1456,315,"DOÑATE, Claudio Martín",172,114,8,181,475,https://votaciones.hcdn.gob.ar/diputado/315
496,614,773,"DRAGAN, Marcelo Luis",45,64,4,52,165,https://votaciones.hcdn.gob.ar/diputado/773
497,413,1507,"DRAGICEVIC, Carmen Nilda",60,20,1,19,100,https://votaciones.hcdn.gob.ar/diputado/1507
498,79,774,"DRISALDI, María Rita",139,69,9,63,280,https://votaciones.hcdn.gob.ar/diputado/774
499,1271,249,"DUCLOS, Omar Arnaldo",149,133,19,106,407,https://votaciones.hcdn.gob.ar/diputado/249
500,414,1584,"DUFOU, Pedro Alfredo",23,14,0,61,98,https://votaciones.hcdn.gob.ar/diputado/1584
501,80,775,"DUMON, José Gabriel",141,84,5,44,274,https://votaciones.hcdn.gob.ar/diputado/775
502,1362,111,"DURAND CORNEJO, Guillermo Mario",271,99,12,108,490,https://votaciones.hcdn.gob.ar/diputado/111
503,81,1211,"DURAÑONA y VEDIA, Francisco",50,28,9,10,97,https://votaciones.hcdn.gob.ar/diputado/1211
504,82,1212,"DURRIEU, Marcela Margarita",83,17,1,10,111,https://votaciones.hcdn.gob.ar/diputado/1212
505,1457,502,"DURÉ, Lucila Beatriz",201,56,13,37,307,https://votaciones.hcdn.gob.ar/diputado/502
506,290,1338,"DUSSOL, Ramón Adolfo",1,0,0,13,14,https://votaciones.hcdn.gob.ar/diputado/1338
507,1185,348,"DUTTO, Gustavo Alberto",31,5,0,12,48,https://votaciones.hcdn.gob.ar/diputado/348
508,513,746,"D`ERRICO, María Rita Antonia",45,42,0,30,117,https://votaciones.hcdn.gob.ar/diputado/746
509,1575,1663,"Del PLÁ, Romina",67,57,16,28,168,https://votaciones.hcdn.gob.ar/diputado/1663
510,1458,231,"ECHEGARAY, Alejandro Carlos Augusto",352,93,5,25,475,https://votaciones.hcdn.gob.ar/diputado/231
511,291,1339,"ECHEVARRIA, Luis María",2,1,0,11,14,https://votaciones.hcdn.gob.ar/diputado/1339
512,1363,435,"EHCOSOR, María Azucena",273,34,24,159,490,https://votaciones.hcdn.gob.ar/diputado/435
513,292,1265,"ELIAS, Angel Mario",7,5,0,2,14,https://votaciones.hcdn.gob.ar/diputado/1265
514,1272,365,"ELICECHE, Carlos Tomas",94,1,0,24,119,https://votaciones.hcdn.gob.ar/diputado/365
515,745,776,"ELIZONDO, Dante",207,18,0,88,313,https://votaciones.hcdn.gob.ar/diputado/776
516,1273,153,"ELORRIAGA, Osvaldo Enrique",387,8,0,12,407,https://votaciones.hcdn.gob.ar/diputado/153
517,1578,1706,"ENRIQUEZ, Jorge Ricardo",101,59,2,6,168,https://votaciones.hcdn.gob.ar/diputado/1706
518,1067,84,"ERRO, Norberto Pedro",246,39,4,76,365,https://votaciones.hcdn.gob.ar/diputado/84
519,746,777,"ESAIN, Daniel Martín",127,25,45,16,213,https://votaciones.hcdn.gob.ar/diputado/777
520,415,1508,"ESCALANTE ORTIZ, Herminia Elsa",64,16,6,14,100,https://votaciones.hcdn.gob.ar/diputado/1508
521,83,778,"ESCOBAR, Jorge Alberto",80,47,2,81,210,https://votaciones.hcdn.gob.ar/diputado/778
522,293,1340,"ESPECHE, Alberto Luis",7,5,0,2,14,https://votaciones.hcdn.gob.ar/diputado/1340
523,1364,487,"ESPER, Laura Reneé",91,31,27,34,183,https://votaciones.hcdn.gob.ar/diputado/487
524,1186,473,"ESPINDOLA, Gladys Susana",111,67,5,140,323,https://votaciones.hcdn.gob.ar/diputado/473
525,615,779,"ESPINOLA, Barbara Ines",36,16,0,10,62,https://votaciones.hcdn.gob.ar/diputado/779
526,1579,1702,"ESPINOZA, Fernando",60,24,2,82,168,https://votaciones.hcdn.gob.ar/diputado/1702
527,852,780,"ESTEBAN, Silvia Graciela",188,9,2,4,203,https://votaciones.hcdn.gob.ar/diputado/780
528,84,1341,"ESTEVEZ BOERO, Guillermo E.",70,51,5,107,233,https://votaciones.hcdn.gob.ar/diputado/1341
529,1459,567,"ESTEVEZ, Gabriela Beatriz",246,173,8,48,475,https://votaciones.hcdn.gob.ar/diputado/567
530,490,1558,"ESTRADA, Arnaldo Damian",46,13,1,27,87,https://votaciones.hcdn.gob.ar/diputado/1558
531,518,781,"ETCHEVEHERE, Arturo Roosevelt",64,23,1,29,117,https://votaciones.hcdn.gob.ar/diputado/781
532,1365,91,"FABIANI, Eduardo Alberto",324,40,30,96,490,https://votaciones.hcdn.gob.ar/diputado/91
533,967,782,"FABRIS, Luciano Rafael",346,146,12,328,832,https://votaciones.hcdn.gob.ar/diputado/782
534,85,1434,"FABRISSIN, Carlos Alberto",76,51,6,31,164,https://votaciones.hcdn.gob.ar/diputado/1434
535,416,1559,"FADEL, Mario Nallib",29,28,0,43,100,https://votaciones.hcdn.gob.ar/diputado/1559
536,853,462,"FADEL, Patricia Susana",871,64,13,113,1061,https://votaciones.hcdn.gob.ar/diputado/462
537,1187,443,"FADUL, Liliana",159,85,5,74,323,https://votaciones.hcdn.gob.ar/diputado/443
538,294,1268,"FAJARDO, Juan Carlos",8,3,0,3,14,https://votaciones.hcdn.gob.ar/diputado/1268
539,616,783,"FALBO, María del Carmen",121,66,8,21,216,https://votaciones.hcdn.gob.ar/diputado/783
540,86,1342,"FALLETI, Julio Cesar José",41,4,1,65,111,https://votaciones.hcdn.gob.ar/diputado/1342
541,747,784,"FALU, José Ricardo",147,5,7,54,213,https://votaciones.hcdn.gob.ar/diputado/784
542,617,785,"FARIZANO, Juan Carlos",60,16,0,8,84,https://votaciones.hcdn.gob.ar/diputado/785
543,1188,173,"FAUSTINELLI, Hipólito",97,48,3,175,323,https://votaciones.hcdn.gob.ar/diputado/173
544,1189,20,"FAVARIO, Carlos Alberto",133,110,9,71,323,https://votaciones.hcdn.gob.ar/diputado/20
545,87,786,"FAYAD, Victor Manuel Federico",141,111,33,209,494,https://votaciones.hcdn.gob.ar/diputado/786
546,1068,431,"FEIN, Mónica Hayde",228,86,2,49,365,https://votaciones.hcdn.gob.ar/diputado/431
547,1274,139,"FELETTI, Roberto José",399,8,0,0,407,https://votaciones.hcdn.gob.ar/diputado/139
548,88,1343,"FELGUERAS, Ricardo Ernesto",45,28,0,38,111,https://votaciones.hcdn.gob.ar/diputado/1343
549,1190,169,"FELIX, Omar",306,43,5,137,491,https://votaciones.hcdn.gob.ar/diputado/169
550,295,106,"FELLNER, Eduardo Alfredo",12,1,0,16,29,https://votaciones.hcdn.gob.ar/diputado/106
551,854,787,"FELLNER, Liliana",125,5,0,7,137,https://votaciones.hcdn.gob.ar/diputado/787
552,1069,793,"FERNANDEZ BASUALDO, Luis María",279,26,2,10,317,https://votaciones.hcdn.gob.ar/diputado/793
553,1427,449,"FERNANDEZ BLANCO, María Cristina",15,5,1,13,34,https://votaciones.hcdn.gob.ar/diputado/449
554,89,1269,"FERNANDEZ GILL, Guillermo",19,23,2,67,111,https://votaciones.hcdn.gob.ar/diputado/1269
555,1580,1657,"FERNANDEZ LANGAN, Ezequiel",105,59,1,3,168,https://votaciones.hcdn.gob.ar/diputado/1657
556,855,795,"FERNANDEZ LIMIA, Adan Noé",72,3,8,23,106,https://votaciones.hcdn.gob.ar/diputado/795
557,90,1435,"FERNANDEZ MEIJIDE, Graciela",40,24,1,65,130,https://votaciones.hcdn.gob.ar/diputado/1435
558,1581,1628,"FERNANDEZ PATRI, Gustavo Ramiro",86,41,5,36,168,https://votaciones.hcdn.gob.ar/diputado/1628
559,1275,581,"FERNANDEZ SAGASTI, Anabel",389,8,0,10,407,https://votaciones.hcdn.gob.ar/diputado/581
560,618,796,"FERNANDEZ VALONI, José Luis",53,43,1,68,165,https://votaciones.hcdn.gob.ar/diputado/796
561,417,1538,"FERNANDEZ de COMBES, Elsa A.",34,36,0,30,100,https://votaciones.hcdn.gob.ar/diputado/1538
562,2,794,"FERNANDEZ de KIRCHNER, Cristina",33,43,7,34,117,https://votaciones.hcdn.gob.ar/diputado/794
563,687,1495,"FERNANDEZ, Adrián Agapito",19,1,2,0,22,https://votaciones.hcdn.gob.ar/diputado/1495
564,418,1585,"FERNANDEZ, Alberto Manuel",39,10,10,34,93,https://votaciones.hcdn.gob.ar/diputado/1585
565,856,788,"FERNANDEZ, Alfredo Cesar",537,30,10,121,698,https://votaciones.hcdn.gob.ar/diputado/788
566,1582,1691,"FERNANDEZ, Carlos Alberto",100,57,0,11,168,https://votaciones.hcdn.gob.ar/diputado/1691
567,748,791,"FERNANDEZ, Horacio Anibal",46,16,3,0,65,https://votaciones.hcdn.gob.ar/diputado/791
568,1070,789,"FERNANDEZ, Marcelo Omar",187,5,3,71,266,https://votaciones.hcdn.gob.ar/diputado/789
569,619,792,"FERNANDEZ, Nicolás Alejandro",17,10,0,57,84,https://votaciones.hcdn.gob.ar/diputado/792
570,520,790,"FERNANDEZ, Pablo Damian",25,1,1,90,117,https://votaciones.hcdn.gob.ar/diputado/790
571,296,1344,"FERNANDEZ, Roberto Carlos",1,0,0,13,14,https://votaciones.hcdn.gob.ar/diputado/1344
572,297,1345,"FERNANDEZ, Roberto Enrique",2,1,0,11,14,https://votaciones.hcdn.gob.ar/diputado/1345
573,1191,353,"FERNANDEZ, Rodolfo Alfredo",125,38,11,149,323,https://votaciones.hcdn.gob.ar/diputado/353
574,1366,118,"FERNÁNDEZ MENDÍA, Gustavo Rodolfo",350,22,9,109,490,https://votaciones.hcdn.gob.ar/diputado/118
575,968,383,"FERRA DE BARTOL, Margarita",686,41,6,399,1132,https://votaciones.hcdn.gob.ar/diputado/383
576,298,1346,"FERRADAS, Miguel Enrique",7,1,1,5,14,https://votaciones.hcdn.gob.ar/diputado/1346
577,620,797,"FERRARI de GRAND, Teresa Hortensia",63,69,5,28,165,https://votaciones.hcdn.gob.ar/diputado/797
578,1192,146,"FERRARI, Gustavo Alfredo",87,71,1,164,323,https://votaciones.hcdn.gob.ar/diputado/146
579,621,798,"FERRERO, Fernanda",41,72,10,42,165,https://votaciones.hcdn.gob.ar/diputado/798
580,1276,521,"FERREYRA, Araceli Susana Del Rosario",557,123,7,195,882,https://votaciones.hcdn.gob.ar/diputado/521
581,299,1347,"FERREYRA, Eduardo Mario",1,0,0,13,14,https://votaciones.hcdn.gob.ar/diputado/1347
582,521,799,"FERREYRA, Mario Felix",44,31,2,40,117,https://votaciones.hcdn.gob.ar/diputado/799
583,857,800,"FERRI, Gustavo Enrique",350,67,41,240,698,https://votaciones.hcdn.gob.ar/diputado/800
584,858,801,"FERRIGNO, Santiago",528,45,24,101,698,https://votaciones.hcdn.gob.ar/diputado/801
585,749,802,"FERRIN, María Teresa",72,104,4,33,213,https://votaciones.hcdn.gob.ar/diputado/802
586,969,803,"FERRO, Francisco José",273,175,24,360,832,https://votaciones.hcdn.gob.ar/diputado/803
587,300,1270,"FESCINA, Andrés Julian",11,2,1,0,14,https://votaciones.hcdn.gob.ar/diputado/1270
588,1193,138,"FIAD, Mario Raymundo",269,145,16,76,506,https://votaciones.hcdn.gob.ar/diputado/138
589,91,1348,"FIGUEROA, Pedro Octavio",70,38,1,69,178,https://votaciones.hcdn.gob.ar/diputado/1348
590,1583,1693,"FILMUS, Daniel",91,47,5,25,168,https://votaciones.hcdn.gob.ar/diputado/1693
591,750,805,"FILOMENO, Alejandro Oscar",152,43,7,11,213,https://votaciones.hcdn.gob.ar/diputado/805
592,859,388,"FIOL, Paulina Esther",930,63,6,64,1063,https://votaciones.hcdn.gob.ar/diputado/388
593,1277,554,"FIORE VIÑUALES, María Cristina del Valle",194,3,0,27,224,https://votaciones.hcdn.gob.ar/diputado/554
594,1584,1615,"FLORES, Danilo Adrián",105,16,5,42,168,https://votaciones.hcdn.gob.ar/diputado/1615
595,1071,99,"FLORES, Héctor Toty",205,147,9,172,533,https://votaciones.hcdn.gob.ar/diputado/99
596,92,806,"FLORES, Rafael Horacio",138,51,6,100,295,https://votaciones.hcdn.gob.ar/diputado/806
597,623,807,"FOCO, Isabel Emilia",60,15,0,9,84,https://votaciones.hcdn.gob.ar/diputado/807
598,624,808,"FOGLIA, Teresa Beatriz",85,29,2,49,165,https://votaciones.hcdn.gob.ar/diputado/808
599,93,809,"FOLLONI, Jorge Oscar",83,23,6,116,228,https://votaciones.hcdn.gob.ar/diputado/809
600,522,810,"FONTANETTO, Beatriz Zulema",63,27,0,7,97,https://votaciones.hcdn.gob.ar/diputado/810
601,625,811,"FONTDEVILA, Pablo Antonio",69,39,3,54,165,https://votaciones.hcdn.gob.ar/diputado/811
602,301,1349,"FONTELA, Moises Eduardo",1,1,0,12,14,https://votaciones.hcdn.gob.ar/diputado/1349
603,1194,78,"FORCONI, Juan Carlos",291,12,2,18,323,https://votaciones.hcdn.gob.ar/diputado/78
604,751,812,"FORESI, Irma Amelia",171,14,7,21,213,https://votaciones.hcdn.gob.ar/diputado/812
605,302,1350,"FORNERON, Lino",4,1,0,9,14,https://votaciones.hcdn.gob.ar/diputado/1350
606,1195,197,"FORTE, Ulises Umberto",167,79,2,75,323,https://votaciones.hcdn.gob.ar/diputado/197
607,1196,85,"FORTUNA, Francisco José",181,62,4,76,323,https://votaciones.hcdn.gob.ar/diputado/85
608,94,1436,"FRAGOSO, Francisco Ulises",69,62,6,27,164,https://votaciones.hcdn.gob.ar/diputado/1436
609,1460,490,"FRANA, Silvina Patricia",210,134,10,121,475,https://votaciones.hcdn.gob.ar/diputado/490
610,1278,260,"FRANCIONI, Fabián Marcelo",351,6,1,49,407,https://votaciones.hcdn.gob.ar/diputado/260
611,860,813,"FRANCO, Hugo Alberto",99,59,9,531,698,https://votaciones.hcdn.gob.ar/diputado/813
612,1461,176,"FRANCO, Jorge Daniel",334,40,9,92,475,https://votaciones.hcdn.gob.ar/diputado/176
613,523,1266,"FRANCOS, Guillermo Alberto",18,39,3,15,75,https://votaciones.hcdn.gob.ar/diputado/1266
614,1585,1671,"FREGONESE, Alicia",106,61,0,1,168,https://votaciones.hcdn.gob.ar/diputado/1671
615,524,814,"FRIGERI, Rodolfo Anibal",209,50,12,59,330,https://votaciones.hcdn.gob.ar/diputado/814
616,303,1351,"FRIGERIO, Octavio",6,2,0,6,14,https://votaciones.hcdn.gob.ar/diputado/1351
617,1586,1666,"FRIZZA, Gabriel Alberto",101,57,1,9,168,https://votaciones.hcdn.gob.ar/diputado/1666
618,95,1437,"FUNES, Carlos Delcio",101,20,3,40,164,https://votaciones.hcdn.gob.ar/diputado/1437
619,626,815,"FUNES, Teodoro Roberto",31,41,0,14,86,https://votaciones.hcdn.gob.ar/diputado/815
620,1462,178,"FURLAN, Francisco Abel",185,138,5,147,475,https://votaciones.hcdn.gob.ar/diputado/178
621,419,1560,"GABRIELLI, Rodolfo Federíco",56,18,1,25,100,https://votaciones.hcdn.gob.ar/diputado/1560
622,1367,168,"GAGLIARDI, Josué",177,4,0,2,183,https://votaciones.hcdn.gob.ar/diputado/168
623,1368,573,"GAILLARD, Ana Carolina",259,84,3,144,490,https://votaciones.hcdn.gob.ar/diputado/573
624,96,1438,"GALANTE, Pedro Jorge Roque",71,27,1,65,164,https://votaciones.hcdn.gob.ar/diputado/1438
625,970,816,"GALANTINI, Eduardo Leonel",503,31,14,284,832,https://votaciones.hcdn.gob.ar/diputado/816
626,525,817,"GALLAND, Gustavo Carlos",74,18,1,24,117,https://votaciones.hcdn.gob.ar/diputado/817
627,1197,371,"GALLARDO, Miriam Graciela del Valle",605,129,6,73,813,https://votaciones.hcdn.gob.ar/diputado/371
628,696,818,"GALLEGO, Raul Edgardo",26,7,0,26,59,https://votaciones.hcdn.gob.ar/diputado/818
629,861,819,"GALLO, Daniel Oscar",374,20,34,270,698,https://votaciones.hcdn.gob.ar/diputado/819
630,97,1352,"GALLO, Orlando Juan",21,26,7,57,111,https://votaciones.hcdn.gob.ar/diputado/1352
631,420,1561,"GALMARINI, Fernando Nicolás",43,14,2,41,100,https://votaciones.hcdn.gob.ar/diputado/1561
632,1026,820,"GALVALISI, Luis Alberto",292,180,6,301,779,https://votaciones.hcdn.gob.ar/diputado/820
633,98,1353,"GALVAN, Raul Alfredo",53,45,1,12,111,https://votaciones.hcdn.gob.ar/diputado/1353
634,1198,565,"GAMBARO, Natalia",92,63,1,167,323,https://votaciones.hcdn.gob.ar/diputado/565
635,304,1354,"GAN, Fernando",4,0,0,10,14,https://votaciones.hcdn.gob.ar/diputado/1354
636,99,1355,"GARAY, Nicolás Alfredo",39,31,4,104,178,https://votaciones.hcdn.gob.ar/diputado/1355
637,305,1213,"GARCIA CUEVA, Ignacio S.",6,3,2,3,14,https://votaciones.hcdn.gob.ar/diputado/1213
638,1072,825,"GARCIA HAMILTON, José Ignacio",60,60,4,42,166,https://votaciones.hcdn.gob.ar/diputado/825
639,1279,531,"GARCIA LARRABURU, Silvina Marcela",212,2,1,9,224,https://votaciones.hcdn.gob.ar/diputado/531
640,972,826,"GARCIA MENDEZ, Emilio Arturo",276,161,23,372,832,https://votaciones.hcdn.gob.ar/diputado/826
641,752,827,"GARCIA MERIDA, Miguel Angel",31,15,1,34,81,https://votaciones.hcdn.gob.ar/diputado/827
642,100,1439,"GARCIA MORENO, Miguel Angel",61,12,2,26,101,https://votaciones.hcdn.gob.ar/diputado/1439
643,526,823,"GARCIA de CANO, Maria Isabel",77,31,2,7,117,https://votaciones.hcdn.gob.ar/diputado/823
644,971,824,"GARCIA de MORENO, Eva",656,35,4,137,832,https://votaciones.hcdn.gob.ar/diputado/824
645,306,1357,"GARCIA de NOVELLI, María",7,5,0,2,14,https://votaciones.hcdn.gob.ar/diputado/1357
646,1587,1656,"GARCIA, Alejandro",103,59,1,5,168,https://votaciones.hcdn.gob.ar/diputado/1656
647,1280,514,"GARCIA, Andrea Fabiana",391,9,1,6,407,https://votaciones.hcdn.gob.ar/diputado/514
648,753,822,"GARCIA, Eduardo Daniel",31,101,12,69,213,https://votaciones.hcdn.gob.ar/diputado/822
649,527,821,"GARCIA, Francisco Alberto",44,43,1,29,117,https://votaciones.hcdn.gob.ar/diputado/821
650,1073,503,"GARCIA, Irma Adriana",199,37,15,114,365,https://votaciones.hcdn.gob.ar/diputado/503
651,307,1356,"GARCIA, Pedro Alberto",5,4,0,5,14,https://votaciones.hcdn.gob.ar/diputado/1356
652,862,390,"GARCIA, Susana Rosa",494,337,42,190,1063,https://votaciones.hcdn.gob.ar/diputado/390
653,973,446,"GARCÍA, María Teresa",1221,183,23,218,1645,https://votaciones.hcdn.gob.ar/diputado/446
654,1074,500,"GARDELLA, Patricia Susana",162,40,10,153,365,https://votaciones.hcdn.gob.ar/diputado/500
655,308,1214,"GARGIULO, Pablo",7,4,0,3,14,https://votaciones.hcdn.gob.ar/diputado/1214
656,704,828,"GARIGLIO, Juan Miguel",2,7,0,11,20,https://votaciones.hcdn.gob.ar/diputado/828
657,863,829,"GARIN de TULA, Lucia",318,169,18,193,698,https://votaciones.hcdn.gob.ar/diputado/829
658,1199,447,"GARNERO, Estela Ramona",126,37,10,150,323,https://votaciones.hcdn.gob.ar/diputado/447
659,1281,94,"GARRAMUÑO, Jorge Alberto",106,58,2,58,224,https://votaciones.hcdn.gob.ar/diputado/94
660,421,830,"GARRE, Nilda Celia",77,37,5,28,147,https://votaciones.hcdn.gob.ar/diputado/830
661,1463,304,"GARRETÓN, Facundo",285,85,5,100,475,https://votaciones.hcdn.gob.ar/diputado/304
662,864,831,"GARRIDO ARCEO, Jorge Antonio",397,80,7,214,698,https://votaciones.hcdn.gob.ar/diputado/831
663,1282,224,"GARRIDO, Manuel",162,139,17,89,407,https://votaciones.hcdn.gob.ar/diputado/224
664,697,832,"GASTAÑAGA, Graciela Ines",64,23,5,26,118,https://votaciones.hcdn.gob.ar/diputado/832
665,309,1215,"GATTI, Héctor Angel",49,24,0,41,114,https://votaciones.hcdn.gob.ar/diputado/1215
666,101,1271,"GAUNA, Juan Octavio",50,46,1,14,111,https://votaciones.hcdn.gob.ar/diputado/1271
667,1464,380,"GAYOL, Yanina Celeste",368,93,3,11,475,https://votaciones.hcdn.gob.ar/diputado/380
668,102,1440,"GAZIA, Rodolfo Mauricio",98,19,5,42,164,https://votaciones.hcdn.gob.ar/diputado/1440
669,1283,42,"GDANSKY, Carlos Enrique",379,8,0,20,407,https://votaciones.hcdn.gob.ar/diputado/42
670,627,833,"GEIJO, Angel Oscar",87,21,5,52,165,https://votaciones.hcdn.gob.ar/diputado/833
671,974,834,"GENEM, Amanda Susana",657,30,6,139,832,https://votaciones.hcdn.gob.ar/diputado/834
672,1075,835,"GEREZ, Elda Ramona",127,75,5,59,266,https://votaciones.hcdn.gob.ar/diputado/835
673,310,1358,"GERMANO, Alberto Raul",5,4,0,5,14,https://votaciones.hcdn.gob.ar/diputado/1358
674,1200,71,"GERMANO, Daniel",91,79,2,151,323,https://votaciones.hcdn.gob.ar/diputado/71
675,1369,328,"GERVASONI, Lautaro",319,70,5,96,490,https://votaciones.hcdn.gob.ar/diputado/328
676,1284,498,"GIACCONE, Claudia Alejandra",395,8,0,4,407,https://votaciones.hcdn.gob.ar/diputado/498
677,975,219,"GIACOMINO, Daniel Oscar",557,19,8,229,813,https://votaciones.hcdn.gob.ar/diputado/219
678,628,411,"GIANNETTASIO, Graciela María",715,82,7,52,856,https://votaciones.hcdn.gob.ar/diputado/411
679,422,1562,"GIANNI, Gloria María Cristina",27,25,1,47,100,https://votaciones.hcdn.gob.ar/diputado/1562
680,1201,49,"GIL LAVEDRA, Ricardo Rodolfo",152,76,2,93,323,https://votaciones.hcdn.gob.ar/diputado/49
681,1076,452,"GIL LOZANO, Claudia Fernanda",176,96,14,79,365,https://votaciones.hcdn.gob.ar/diputado/452
682,528,838,"GILES, Guillermo Jorge",54,32,4,27,117,https://votaciones.hcdn.gob.ar/diputado/838
683,1370,300,"GILL, Martín Rodrigo",175,4,4,0,183,https://votaciones.hcdn.gob.ar/diputado/300
684,311,1486,"GIMENEZ REBORA, José Adolfo",2,1,1,0,4,https://votaciones.hcdn.gob.ar/diputado/1486
685,103,1441,"GIMENEZ, Delfor Abel",60,13,2,11,86,https://votaciones.hcdn.gob.ar/diputado/1441
686,104,1442,"GIMENEZ, Ramón Francisco",102,23,0,39,164,https://votaciones.hcdn.gob.ar/diputado/1442
687,1371,489,"GIMÉNEZ, Patricia Viviana",338,104,18,25,485,https://votaciones.hcdn.gob.ar/diputado/489
688,1588,1629,"GINOCCHIO, Silvana Micaela",142,19,2,5,168,https://votaciones.hcdn.gob.ar/diputado/1629
689,976,839,"GINZBURG, Nora Raquel",239,147,11,435,832,https://votaciones.hcdn.gob.ar/diputado/839
690,105,45,"GIOJA, José Luis",272,94,11,207,584,https://votaciones.hcdn.gob.ar/diputado/45
691,865,135,"GIOJA, Juan Carlos",652,41,5,365,1063,https://votaciones.hcdn.gob.ar/diputado/135
692,1465,1179,"GIORDANO, Juan Carlos",39,61,19,7,126,https://votaciones.hcdn.gob.ar/diputado/1179
693,866,840,"GIORGETTI, Jorge Raúl",430,28,17,223,698,https://votaciones.hcdn.gob.ar/diputado/840
694,629,97,"GIUBERGIA, Miguel Angel",662,407,35,497,1601,https://votaciones.hcdn.gob.ar/diputado/97
695,867,484,"GIUDICI, Silvana Myriam",341,206,32,484,1063,https://votaciones.hcdn.gob.ar/diputado/484
696,529,841,"GIUSTINIANI, Rubén Hector",89,58,12,39,198,https://votaciones.hcdn.gob.ar/diputado/841
697,1372,229,"GIUSTOZZI, Rubén Darío",190,25,32,243,490,https://votaciones.hcdn.gob.ar/diputado/229
698,868,842,"GODOY, Juan Carlos",230,116,55,297,698,https://votaciones.hcdn.gob.ar/diputado/842
699,423,843,"GODOY, Norma",45,21,3,118,187,https://votaciones.hcdn.gob.ar/diputado/843
700,869,92,"GODOY, Ruperto Eduardo",862,62,5,134,1063,https://votaciones.hcdn.gob.ar/diputado/92
701,1466,242,"GOICOECHEA, Horacio",370,92,4,9,475,https://votaciones.hcdn.gob.ar/diputado/242
702,424,1563,"GOLLY, Eduardo Ceferino",62,17,0,21,100,https://votaciones.hcdn.gob.ar/diputado/1563
703,106,1272,"GOLPE MONTIEL, Nestor Lino",18,17,3,73,111,https://votaciones.hcdn.gob.ar/diputado/1272
704,107,1443,"GOLPE, Carlos Horacio",109,25,4,26,164,https://votaciones.hcdn.gob.ar/diputado/1443
705,1373,303,"GOMEZ BULL, Mauricio Ricardo",236,75,2,177,490,https://votaciones.hcdn.gob.ar/diputado/303
706,108,1359,"GOMEZ CENTURION, Carlos E.",47,17,1,46,111,https://votaciones.hcdn.gob.ar/diputado/1359
707,425,845,"GOMEZ DIEZ, Ricardo",85,26,6,67,184,https://votaciones.hcdn.gob.ar/diputado/845
708,312,1216,"GOMEZ, José Ernesto",11,2,0,1,14,https://votaciones.hcdn.gob.ar/diputado/1216
709,754,844,"GOMEZ, Ricardo Carmelo",39,15,6,21,81,https://votaciones.hcdn.gob.ar/diputado/844
710,313,1217,"GOMEZ, Roque Julio Cesar",3,0,0,11,14,https://votaciones.hcdn.gob.ar/diputado/1217
711,530,851,"GONZALEZ CABAÑAS, José Armando",25,20,11,61,117,https://votaciones.hcdn.gob.ar/diputado/851
712,109,1218,"GONZALEZ CABAÑAS, Tomás W.",70,16,2,23,111,https://votaciones.hcdn.gob.ar/diputado/1218
713,314,1273,"GONZALEZ GASS, Gabriela Marta",6,7,0,1,14,https://votaciones.hcdn.gob.ar/diputado/1273
714,110,1275,"GONZALEZ GAVIOLA, Juan Horacio",72,42,6,91,211,https://votaciones.hcdn.gob.ar/diputado/1275
715,531,852,"GONZALEZ de DUHALDE, Ilda",69,32,6,142,249,https://votaciones.hcdn.gob.ar/diputado/852
716,315,1360,"GONZALEZ, Alberto Ignacio",2,0,0,12,14,https://votaciones.hcdn.gob.ar/diputado/1360
717,111,1444,"GONZALEZ, Antonio Erman",67,19,6,51,143,https://votaciones.hcdn.gob.ar/diputado/1444
718,870,848,"GONZALEZ, Jorge Pedro",350,11,7,330,698,https://votaciones.hcdn.gob.ar/diputado/848
719,1077,208,"GONZALEZ, Juan Dante",574,36,0,162,772,https://votaciones.hcdn.gob.ar/diputado/208
720,316,1274,"GONZALEZ, Luis Mario",8,6,0,0,14,https://votaciones.hcdn.gob.ar/diputado/1274
721,532,847,"GONZALEZ, María América",519,322,73,248,1162,https://votaciones.hcdn.gob.ar/diputado/847
722,426,1564,"GONZALEZ, María Luisa",64,17,2,17,100,https://votaciones.hcdn.gob.ar/diputado/1564
723,1027,480,"GONZALEZ, Nancy Susana",739,56,6,135,936,https://votaciones.hcdn.gob.ar/diputado/480
724,533,849,"GONZALEZ, Oscar Felix",133,26,6,79,244,https://votaciones.hcdn.gob.ar/diputado/849
725,705,850,"GONZALEZ, Oscar Roberto",28,36,14,25,103,https://votaciones.hcdn.gob.ar/diputado/850
726,755,846,"GONZALEZ, Rafael Alfredo",185,22,3,3,213,https://votaciones.hcdn.gob.ar/diputado/846
727,1375,543,"GONZALEZ, Verónica Evangelina",179,4,0,0,183,https://votaciones.hcdn.gob.ar/diputado/543
728,1589,1182,"GONZÁLEZ SELIGRA, Nathalia",94,96,30,22,242,https://votaciones.hcdn.gob.ar/diputado/1182
729,1202,550,"GONZÁLEZ, Gladys Esther",328,134,13,221,696,https://votaciones.hcdn.gob.ar/diputado/550
730,1374,564,"GONZÁLEZ, Josefina Victoria",345,148,4,161,658,https://votaciones.hcdn.gob.ar/diputado/564
731,1467,142,"GONZÁLEZ, Álvaro Gustavo",336,100,5,34,475,https://votaciones.hcdn.gob.ar/diputado/142
732,691,1509,"GORANSKY, Fenny",2,0,0,5,7,https://votaciones.hcdn.gob.ar/diputado/1509
733,977,853,"GORBACZ, Leonardo Ariel",537,193,33,69,832,https://votaciones.hcdn.gob.ar/diputado/853
734,427,1593,"GORINI, Florial Edmundo",30,21,2,14,67,https://votaciones.hcdn.gob.ar/diputado/1593
735,534,854,"GORVEIN, Diego Rodolfo",53,53,1,10,117,https://votaciones.hcdn.gob.ar/diputado/854
736,756,855,"GOY, Beatriz Norma",139,16,0,58,213,https://votaciones.hcdn.gob.ar/diputado/855
737,428,1565,"GOÑI, María Virginia",32,13,0,55,100,https://votaciones.hcdn.gob.ar/diputado/1565
738,1468,279,"GRANA, Adrián Eduardo",222,159,11,83,475,https://votaciones.hcdn.gob.ar/diputado/279
739,112,450,"GRANADOS, Dulce",529,82,6,477,1094,https://votaciones.hcdn.gob.ar/diputado/450
740,1590,1635,"GRANDE, Martín",105,48,0,15,168,https://votaciones.hcdn.gob.ar/diputado/1635
741,1469,252,"GRANDINETTI, Alejandro Ariel",345,34,17,79,475,https://votaciones.hcdn.gob.ar/diputado/252
742,113,1219,"GREEN, Gustavo Adolfo",78,17,0,16,111,https://votaciones.hcdn.gob.ar/diputado/1219
743,1078,302,"GRIBAUDO, Christian Alejandro",195,134,20,199,548,https://votaciones.hcdn.gob.ar/diputado/302
744,630,856,"GROSSO, Edgardo Roger Miguel",104,31,6,24,165,https://votaciones.hcdn.gob.ar/diputado/856
745,1285,334,"GROSSO, Leonardo",565,145,3,169,882,https://votaciones.hcdn.gob.ar/diputado/334
746,1286,83,"GUCCIONE, José Daniel",383,8,2,14,407,https://votaciones.hcdn.gob.ar/diputado/83
747,491,1510,"GUDIÑO, Hermelinda Amalia",64,21,3,6,94,https://votaciones.hcdn.gob.ar/diputado/1510
748,1151,857,"GUERCI de SIUFI, Beatriz Elvira",22,25,1,61,109,https://votaciones.hcdn.gob.ar/diputado/857
749,1470,404,"GUERIN, María Isabel",205,142,7,121,475,https://votaciones.hcdn.gob.ar/diputado/404
750,317,1220,"GUERRERO, Antonio Isaac",11,2,0,1,14,https://votaciones.hcdn.gob.ar/diputado/1220
751,114,1244,"GUERRERO, Luis Serafín",30,8,1,72,111,https://votaciones.hcdn.gob.ar/diputado/1244
752,492,858,"GUEVARA, Cristina Rosalía",100,55,4,23,182,https://votaciones.hcdn.gob.ar/diputado/858
753,1079,34,"GULLO, Juan Carlos Dante",317,29,1,18,365,https://votaciones.hcdn.gob.ar/diputado/34
754,706,861,"GUTIERREZ, Alicia Veronica",27,23,11,27,88,https://votaciones.hcdn.gob.ar/diputado/861
755,429,1511,"GUTIERREZ, Diana Bárbara",56,18,1,25,100,https://votaciones.hcdn.gob.ar/diputado/1511
756,757,862,"GUTIERREZ, Francisco Virgilio",471,60,14,234,779,https://votaciones.hcdn.gob.ar/diputado/862
757,978,859,"GUTIERREZ, Graciela Beatriz",626,27,3,176,832,https://votaciones.hcdn.gob.ar/diputado/859
758,430,860,"GUTIERREZ, Gustavo Eduardo",82,63,12,108,265,https://votaciones.hcdn.gob.ar/diputado/860
759,1376,82,"GUTIERREZ, Héctor María",173,71,8,238,490,https://votaciones.hcdn.gob.ar/diputado/82
760,758,863,"GUTIERREZ, Julio César",178,10,5,20,213,https://votaciones.hcdn.gob.ar/diputado/863
761,1287,529,"GUTIERREZ, Mónica Edith",359,8,5,35,407,https://votaciones.hcdn.gob.ar/diputado/529
762,115,1276,"GUZMAN, María Cristina",63,24,5,119,211,https://votaciones.hcdn.gob.ar/diputado/1276
763,1203,467,"GUZMAN, Olga Elizabeth",259,19,2,43,323,https://votaciones.hcdn.gob.ar/diputado/467
764,1471,338,"GUZMÁN, Andrés Ernesto",123,14,5,165,307,https://votaciones.hcdn.gob.ar/diputado/338
765,1377,222,"GUZMÁN, Sandro Adrián",255,19,6,210,490,https://votaciones.hcdn.gob.ar/diputado/222
766,1080,864,"HALAK, Beatriz Susana",127,24,8,107,266,https://votaciones.hcdn.gob.ar/diputado/864
767,431,1512,"HAQUIM, Carlos Guillermo",58,22,0,20,100,https://votaciones.hcdn.gob.ar/diputado/1512
768,116,1361,"HARDY, Anibal Osvaldo",70,17,8,16,111,https://votaciones.hcdn.gob.ar/diputado/1361
769,1288,278,"HARISPE, Gastón",391,8,4,4,407,https://votaciones.hcdn.gob.ar/diputado/278
770,1204,381,"HELLER, Carlos Salomón",501,94,7,211,813,https://votaciones.hcdn.gob.ar/diputado/381
771,979,865,"HEREDIA, Arturo Miguel",641,48,22,121,832,https://votaciones.hcdn.gob.ar/diputado/865
772,117,1277,"HERNANDEZ, Antonio María",40,23,3,45,111,https://votaciones.hcdn.gob.ar/diputado/1277
773,871,866,"HERNANDEZ, Cinthya Gabriela",289,150,31,228,698,https://votaciones.hcdn.gob.ar/diputado/866
774,318,1362,"HERNANDEZ, Santos Abel",1,0,0,13,14,https://votaciones.hcdn.gob.ar/diputado/1362
775,631,867,"HERNANDEZ, Simón Fermín",90,34,2,39,165,https://votaciones.hcdn.gob.ar/diputado/867
776,1472,294,"HERNÁNDEZ, Martín Osvaldo",350,99,1,25,475,https://votaciones.hcdn.gob.ar/diputado/294
777,118,1364,"HERRERA ARIAS, Manuel H.",84,19,2,106,211,https://votaciones.hcdn.gob.ar/diputado/1364
778,535,870,"HERRERA PAEZ, Enzo Thelismar",67,33,2,15,117,https://votaciones.hcdn.gob.ar/diputado/870
779,432,869,"HERRERA, Alberto",662,88,6,340,1096,https://votaciones.hcdn.gob.ar/diputado/869
780,119,1221,"HERRERA, Bernardo Eligio",64,10,1,36,111,https://votaciones.hcdn.gob.ar/diputado/1221
781,759,369,"HERRERA, Griselda Noemí",1081,86,24,261,1452,https://votaciones.hcdn.gob.ar/diputado/369
782,1081,192,"HERRERA, José Alberto",732,50,2,255,1039,https://votaciones.hcdn.gob.ar/diputado/192
783,1473,50,"HERRERA, Luis Beder",118,20,9,328,475,https://votaciones.hcdn.gob.ar/diputado/50
784,319,1363,"HERRERA, Luis Fernando",4,0,0,10,14,https://votaciones.hcdn.gob.ar/diputado/1363
785,1474,530,"HERS CABRAL, Anabella Ruth",284,72,3,92,451,https://votaciones.hcdn.gob.ar/diputado/530
786,632,871,"HERZOVICH, María Elena",91,28,3,43,165,https://votaciones.hcdn.gob.ar/diputado/871
787,633,872,"HONCHERUK, Atlanto",51,48,3,63,165,https://votaciones.hcdn.gob.ar/diputado/872
788,1475,409,"HORNE, Silvia Renee",212,124,11,128,475,https://votaciones.hcdn.gob.ar/diputado/409
789,1082,532,"HOTTON, Cynthia Liliana",138,101,6,120,365,https://votaciones.hcdn.gob.ar/diputado/532
790,1476,582,"HUCZAK, Stella Maris",370,96,4,5,475,https://votaciones.hcdn.gob.ar/diputado/582
791,760,873,"HUMADA, Julio Cesar",109,17,4,83,213,https://votaciones.hcdn.gob.ar/diputado/873
792,120,1365,"HUMADA, Raul",66,19,1,25,111,https://votaciones.hcdn.gob.ar/diputado/1365
793,1591,1705,"HUMMEL, Astrid",103,59,2,4,168,https://votaciones.hcdn.gob.ar/diputado/1705
794,1477,335,"HUSS, Juan  Manuel",215,152,7,101,475,https://votaciones.hcdn.gob.ar/diputado/335
795,1289,535,"IANNI, Ana María",373,8,2,24,407,https://votaciones.hcdn.gob.ar/diputado/535
796,121,1366,"IBARBIA, José María",27,27,2,55,111,https://votaciones.hcdn.gob.ar/diputado/1366
797,1205,538,"IBARRA, Eduardo Mauricio",100,42,4,177,323,https://votaciones.hcdn.gob.ar/diputado/538
798,1083,482,"IBARRA, Vilma Lidia",166,25,21,153,365,https://votaciones.hcdn.gob.ar/diputado/482
799,122,1278,"IBARRECHE, Julio Cesar",37,38,6,30,111,https://votaciones.hcdn.gob.ar/diputado/1278
800,320,1367,"IGLESIAS, Evaristo Constantino",6,4,0,4,14,https://votaciones.hcdn.gob.ar/diputado/1367
801,1084,454,"IGLESIAS, Fernando Adolfo",241,146,12,134,533,https://votaciones.hcdn.gob.ar/diputado/454
802,872,874,"IGLESIAS, Roberto Raul",213,157,13,315,698,https://votaciones.hcdn.gob.ar/diputado/874
803,1478,324,"IGON, Santiago Nicolás",222,166,7,80,475,https://votaciones.hcdn.gob.ar/diputado/324
804,980,875,"ILARREGUI, Luis Alfredo",641,33,25,133,832,https://votaciones.hcdn.gob.ar/diputado/875
805,433,1586,"ILLIA, Martín Arturo",34,33,0,26,93,https://votaciones.hcdn.gob.ar/diputado/1586
806,1479,271,"INCICCO, Lucas Ciriaco",364,99,3,9,475,https://votaciones.hcdn.gob.ar/diputado/271
807,634,876,"INDA, Graciela Ester",61,19,1,3,84,https://votaciones.hcdn.gob.ar/diputado/876
808,1592,1688,"INFANTE, Hugo Orlando",44,10,1,89,144,https://votaciones.hcdn.gob.ar/diputado/1688
809,873,877,"INGRAM, Roddy Ernesto",469,27,2,200,698,https://votaciones.hcdn.gob.ar/diputado/877
810,1423,284,"INSAURRALDE, Martín",33,0,0,66,99,https://votaciones.hcdn.gob.ar/diputado/284
811,635,878,"INSFRAN, Miguel Angel",84,21,7,53,165,https://votaciones.hcdn.gob.ar/diputado/878
812,636,879,"IPARRAGUIRRE, Carlos Raúl",74,28,3,38,143,https://votaciones.hcdn.gob.ar/diputado/879
813,369,1222,"IRIBARNE, Alberto Juan",8,1,0,1,10,https://votaciones.hcdn.gob.ar/diputado/1222
814,874,170,"IRRAZABAL, Juan Manuel",675,53,9,326,1063,https://votaciones.hcdn.gob.ar/diputado/170
815,434,1513,"IRRAZABAL, Liliana María",58,19,0,23,100,https://votaciones.hcdn.gob.ar/diputado/1513
816,1378,578,"ISA, Evita Nélida",317,14,4,155,490,https://votaciones.hcdn.gob.ar/diputado/578
817,435,1514,"ISEQUILLA, Amalia",48,27,5,20,100,https://votaciones.hcdn.gob.ar/diputado/1514
818,761,880,"ISLA de SARACENI, Celia Anita",143,20,15,35,213,https://votaciones.hcdn.gob.ar/diputado/880
819,1206,413,"ITURRASPE, Nora Graciela",130,66,17,110,323,https://votaciones.hcdn.gob.ar/diputado/413
820,123,1223,"ITURRE, Cesar Eusebio",64,9,2,36,111,https://votaciones.hcdn.gob.ar/diputado/1223
821,981,881,"ITURRIETA, Miguel Angel",699,58,10,65,832,https://votaciones.hcdn.gob.ar/diputado/881
822,321,882,"JALIL, Luis Julián",31,24,4,168,227,https://votaciones.hcdn.gob.ar/diputado/882
823,875,883,"JANO, Ricardo Javier",153,156,9,380,698,https://votaciones.hcdn.gob.ar/diputado/883
824,762,884,"JAROSLAVSKY, Gracia Maria",84,72,7,50,213,https://votaciones.hcdn.gob.ar/diputado/884
825,763,885,"JARQUE, Margarita Ofelia",64,88,25,36,213,https://votaciones.hcdn.gob.ar/diputado/885
826,124,1194,"JAUNARENA, José Horacio",99,76,1,35,211,https://votaciones.hcdn.gob.ar/diputado/1194
827,1379,290,"JAVKIN, Pablo Lautaro",78,59,11,35,183,https://votaciones.hcdn.gob.ar/diputado/290
828,637,886,"JENEFES, Guillermo Raul",19,33,2,30,84,https://votaciones.hcdn.gob.ar/diputado/886
829,876,887,"JEREZ, Esteban Eduardo",191,114,7,318,630,https://votaciones.hcdn.gob.ar/diputado/887
830,877,888,"JEREZ, Eusebia Antonia",229,116,38,315,698,https://votaciones.hcdn.gob.ar/diputado/888
831,638,889,"JOBE, Miguel Antonio",40,85,13,27,165,https://votaciones.hcdn.gob.ar/diputado/889
832,436,1566,"JOGA, Vicente Bienvenido",28,15,5,52,100,https://votaciones.hcdn.gob.ar/diputado/1566
833,764,890,"JOHNSON, Guillermo",179,15,4,15,213,https://votaciones.hcdn.gob.ar/diputado/890
834,125,1445,"JUNCOSA, Rodolfo Aldo",83,38,1,42,164,https://votaciones.hcdn.gob.ar/diputado/1445
835,1290,35,"JUNIO, Juan Carlos Isaac",386,7,3,11,407,https://votaciones.hcdn.gob.ar/diputado/35
836,536,1267,"JURI, Amado Nicomedes",28,28,0,19,75,https://votaciones.hcdn.gob.ar/diputado/1267
837,1207,528,"JURI, Mariana",133,76,6,108,323,https://votaciones.hcdn.gob.ar/diputado/528
838,1380,119,"JUÁREZ, Manuel Humberto",418,26,2,44,490,https://votaciones.hcdn.gob.ar/diputado/119
839,1381,527,"JUÁREZ, Myrian del Valle",315,114,5,56,490,https://votaciones.hcdn.gob.ar/diputado/527
840,126,1446,"KAEHLER, Ernesto Rolando",72,14,0,78,164,https://votaciones.hcdn.gob.ar/diputado/1446
841,982,891,"KAKUBUR, Emilio",421,21,4,386,832,https://votaciones.hcdn.gob.ar/diputado/891
842,127,1447,"KAMMERATH, Germán Luis",27,20,1,62,110,https://votaciones.hcdn.gob.ar/diputado/1447
843,1085,164,"KATZ, Daniel",144,53,1,167,365,https://votaciones.hcdn.gob.ar/diputado/164
844,128,1368,"KELLY, Elsa Diana Rosa",33,59,3,16,111,https://votaciones.hcdn.gob.ar/diputado/1368
845,1086,76,"KENNY, Eduardo Enrique Federico",152,72,11,130,365,https://votaciones.hcdn.gob.ar/diputado/76
846,537,892,"KENT de SAADI, María del Pilar",37,29,0,51,117,https://votaciones.hcdn.gob.ar/diputado/892
847,129,1448,"KESSLER, Ana Raquel",71,12,3,78,164,https://votaciones.hcdn.gob.ar/diputado/1448
848,1480,288,"KICILLOF, Axel",215,150,8,102,475,https://votaciones.hcdn.gob.ar/diputado/288
849,1481,320,"KIRCHNER, Máximo Carlos",198,118,9,150,475,https://votaciones.hcdn.gob.ar/diputado/320
850,1,893,"KIRCHNER, Néstor Carlos",1,0,0,50,51,https://votaciones.hcdn.gob.ar/diputado/893
851,1087,425,"KORENFELD, Beatriz Liliana",271,23,1,70,365,https://votaciones.hcdn.gob.ar/diputado/425
852,1291,227,"KOSINER, Pablo Francisco Juan",810,37,15,20,882,https://votaciones.hcdn.gob.ar/diputado/227
853,130,1369,"KOTH, Carlos",46,26,5,34,111,https://votaciones.hcdn.gob.ar/diputado/1369
854,983,163,"KRONEBERGER, Daniel Ricardo",668,258,31,757,1714,https://votaciones.hcdn.gob.ar/diputado/163
855,765,895,"KUNEY, Mónica Adriana",164,12,6,31,213,https://votaciones.hcdn.gob.ar/diputado/895
856,984,11,"KUNKEL, Carlos Miguel",1182,130,7,326,1645,https://votaciones.hcdn.gob.ar/diputado/11
857,766,896,"L'HUILLIER, José Guillermo",30,83,7,93,213,https://votaciones.hcdn.gob.ar/diputado/896
858,1593,1651,"LACOSTE, Jorge Enrique",86,58,0,24,168,https://votaciones.hcdn.gob.ar/diputado/1651
859,131,897,"LAFALLA, Arturo Pedro",130,42,16,74,262,https://votaciones.hcdn.gob.ar/diputado/897
860,437,1567,"LAFFERRIERE, Ricardo Emilio",2,3,0,95,100,https://votaciones.hcdn.gob.ar/diputado/1567
861,1382,387,"LAGORIA, Elia Nelly",326,30,29,105,490,https://votaciones.hcdn.gob.ar/diputado/387
862,132,1449,"LAHOZ, José Fernando",91,21,3,49,164,https://votaciones.hcdn.gob.ar/diputado/1449
863,133,898,"LAMBERTO, Oscar Santiago",519,94,31,291,935,https://votaciones.hcdn.gob.ar/diputado/898
864,639,899,"LAMISOVSKY, Arnaldo",64,50,2,49,165,https://votaciones.hcdn.gob.ar/diputado/899
865,1088,152,"LANCETA, Rubén Orfel",159,92,10,104,365,https://votaciones.hcdn.gob.ar/diputado/152
866,924,33,"LANDAU, Jorge Alberto",1009,69,32,355,1465,https://votaciones.hcdn.gob.ar/diputado/33
867,640,900,"LANZA, José Luis",61,19,1,3,84,https://votaciones.hcdn.gob.ar/diputado/900
868,134,901,"LARRABURU, Damaso",105,51,3,69,228,https://votaciones.hcdn.gob.ar/diputado/901
869,767,902,"LARREGUY, Carlos Alberto",167,27,1,18,213,https://votaciones.hcdn.gob.ar/diputado/902
870,1292,379,"LARROQUE, Andrés",553,156,7,166,882,https://votaciones.hcdn.gob.ar/diputado/379
871,1428,298,"LASPINA, Luciano Andrés",354,112,7,61,534,https://votaciones.hcdn.gob.ar/diputado/298
872,538,903,"LATORRE, Roxana Itati",18,4,1,94,117,https://votaciones.hcdn.gob.ar/diputado/903
873,985,904,"LAURITTO, José Eduardo",505,24,1,36,566,https://votaciones.hcdn.gob.ar/diputado/904
874,1482,308,"LAVAGNA, Marco",392,30,28,25,475,https://votaciones.hcdn.gob.ar/diputado/308
875,1594,1633,"LEAVY, Sergio Napoleón",70,24,4,70,168,https://votaciones.hcdn.gob.ar/diputado/1633
876,135,1279,"LECONTE, Ricardo Guillermo",29,34,2,46,111,https://votaciones.hcdn.gob.ar/diputado/1279
877,1089,130,"LEDESMA, Julio Rubén",138,89,10,352,589,https://votaciones.hcdn.gob.ar/diputado/130
878,1143,905,"LEGUIZAMON, Anibal Ernesto",35,3,6,48,92,https://votaciones.hcdn.gob.ar/diputado/905
879,136,512,"LEGUIZAMON, María Laura",337,46,3,143,529,https://votaciones.hcdn.gob.ar/diputado/512
880,1595,1650,"LEHMANN, María Lucila",87,58,2,21,168,https://votaciones.hcdn.gob.ar/diputado/1650
881,878,906,"LEMME, María Alicia",46,25,18,534,623,https://votaciones.hcdn.gob.ar/diputado/906
882,986,907,"LEMOS, Silvia Beatriz",265,172,31,364,832,https://votaciones.hcdn.gob.ar/diputado/907
883,438,1515,"LENCE, Héctor",40,15,3,42,100,https://votaciones.hcdn.gob.ar/diputado/1515
884,1146,908,"LENZ, María Beatriz",195,7,0,49,251,https://votaciones.hcdn.gob.ar/diputado/908
885,768,909,"LEONELLI, María Silvina",72,96,3,42,213,https://votaciones.hcdn.gob.ar/diputado/909
886,769,910,"LERNOUD, María Teresa",34,25,2,20,81,https://votaciones.hcdn.gob.ar/diputado/910
887,1090,493,"LEVERBERG, Stella Maris",675,37,6,54,772,https://votaciones.hcdn.gob.ar/diputado/493
888,539,911,"LEYBA de MARTI, Beatriz",434,218,18,145,815,https://votaciones.hcdn.gob.ar/diputado/911
889,1091,486,"LINARES, María Virginia",352,184,27,209,772,https://votaciones.hcdn.gob.ar/diputado/486
890,641,912,"LINARES, María del Carmen",63,17,2,2,84,https://votaciones.hcdn.gob.ar/diputado/912
891,439,1516,"LIPONEZKY de AMAVET, Sara G.",58,19,4,19,100,https://votaciones.hcdn.gob.ar/diputado/1516
892,1483,259,"LIPOVETZKY, Daniel Andrés",348,91,4,32,475,https://votaciones.hcdn.gob.ar/diputado/259
893,540,913,"LISSI, Liliana",74,32,2,9,117,https://votaciones.hcdn.gob.ar/diputado/913
894,1484,485,"LITZA, Mónica Edith",243,8,4,52,307,https://votaciones.hcdn.gob.ar/diputado/485
895,698,914,"LIX KLETT, Roberto Ignacio",233,147,33,415,828,https://votaciones.hcdn.gob.ar/diputado/914
896,879,915,"LLAMBI, Susana Beatriz",117,7,0,8,132,https://votaciones.hcdn.gob.ar/diputado/915
897,541,916,"LLAMOSAS, Fernando Elías",61,25,0,31,117,https://votaciones.hcdn.gob.ar/diputado/916
898,770,917,"LLANO, Gabriel Joaquín",42,52,21,98,213,https://votaciones.hcdn.gob.ar/diputado/917
899,1485,474,"LLANOS MASSA, Ana María",233,169,13,60,475,https://votaciones.hcdn.gob.ar/diputado/474
900,1147,918,"LLANOS, Edith",236,6,1,8,251,https://votaciones.hcdn.gob.ar/diputado/918
901,1208,273,"LLANOS, Ermindo Edgardo Marcelo",211,22,2,88,323,https://votaciones.hcdn.gob.ar/diputado/273
902,1596,1680,"LLARYORA, Martín Miguel",105,13,2,48,168,https://votaciones.hcdn.gob.ar/diputado/1680
903,1092,141,"LLERA, Timoteo",307,28,5,25,365,https://votaciones.hcdn.gob.ar/diputado/141
904,137,1450,"LLOPIS, Enrique Raúl",49,19,3,93,164,https://votaciones.hcdn.gob.ar/diputado/1450
905,771,920,"LOFRANO, Elsa Gladi",61,12,3,3,79,https://votaciones.hcdn.gob.ar/diputado/920
906,1486,518,"LOPARDO, María Paula",268,38,1,0,307,https://votaciones.hcdn.gob.ar/diputado/518
907,138,57,"LOPEZ ARIAS, Marcelo Eduardo",261,78,16,258,613,https://votaciones.hcdn.gob.ar/diputado/57
908,322,1370,"LOPEZ de ZAVALIA, Fernando J.",5,7,0,2,14,https://votaciones.hcdn.gob.ar/diputado/1370
909,139,1280,"LOPEZ, Alcides Humberto",19,32,8,52,111,https://votaciones.hcdn.gob.ar/diputado/1280
910,1028,922,"LOPEZ, Amelia de los Milagros",386,23,3,70,482,https://votaciones.hcdn.gob.ar/diputado/922
911,440,1517,"LOPEZ, Elsa Isabel",66,23,0,11,100,https://votaciones.hcdn.gob.ar/diputado/1517
912,1093,924,"LOPEZ, Ernesto Segundo",220,9,0,37,266,https://votaciones.hcdn.gob.ar/diputado/924
913,140,1451,"LOPEZ, José Augusto",94,28,0,42,164,https://votaciones.hcdn.gob.ar/diputado/1451
914,925,923,"LOPEZ, Juan Carlos",46,41,9,33,129,https://votaciones.hcdn.gob.ar/diputado/923
915,772,921,"LOPEZ, Juan Carlos.",32,17,3,29,81,https://votaciones.hcdn.gob.ar/diputado/921
916,1094,47,"LOPEZ, Rafael Angel",215,17,5,128,365,https://votaciones.hcdn.gob.ar/diputado/47
917,987,926,"LORENZO BOROCOTO, Eduardo",408,22,20,382,832,https://votaciones.hcdn.gob.ar/diputado/926
918,642,925,"LORENZO, Antonio Arnaldo",79,26,5,55,165,https://votaciones.hcdn.gob.ar/diputado/925
919,1152,10,"LORGES, Juan Carlos",73,8,0,127,208,https://votaciones.hcdn.gob.ar/diputado/10
920,141,1371,"LOSADA, Luis Enrique",42,30,3,36,111,https://votaciones.hcdn.gob.ar/diputado/1371
921,1488,566,"LOSPENNATO, Silvia Gabriela",371,101,1,2,475,https://votaciones.hcdn.gob.ar/diputado/566
922,1293,421,"LOTTO, Inés Beatriz",611,152,6,113,882,https://votaciones.hcdn.gob.ar/diputado/421
923,1384,286,"LOUSTEAU, Martín",139,57,16,139,351,https://votaciones.hcdn.gob.ar/diputado/286
924,142,927,"LOUTAIF, Julio César",56,27,9,20,112,https://votaciones.hcdn.gob.ar/diputado/927
925,880,928,"LOVAGLIO SARAVIA, Antonio",522,45,4,127,698,https://votaciones.hcdn.gob.ar/diputado/928
926,881,145,"LOZANO, Claudio Raúl",507,337,136,490,1470,https://votaciones.hcdn.gob.ar/diputado/145
927,773,929,"LOZANO, Encarnación",36,39,17,121,213,https://votaciones.hcdn.gob.ar/diputado/929
928,922,930,"LUBERTINO, María José",2,6,0,16,24,https://votaciones.hcdn.gob.ar/diputado/930
929,774,931,"LUGO de GONZALES CABAÑAS, Cecilia",142,19,5,47,213,https://votaciones.hcdn.gob.ar/diputado/931
930,1095,391,"LUNA DE MARCOS, Ana Zulema",300,27,2,36,365,https://votaciones.hcdn.gob.ar/diputado/391
931,489,1707,"LUNA, Hernán Daniel",1,12,1,0,14,https://votaciones.hcdn.gob.ar/diputado/1707
932,707,79,"LUSQUIÑOS, Luis Bernardo",401,107,34,521,1063,https://votaciones.hcdn.gob.ar/diputado/79
933,143,1372,"LYNCH, Carlos Alberto",22,6,0,83,111,https://votaciones.hcdn.gob.ar/diputado/1372
934,708,933,"LYNCH, Juan Carlos",31,30,7,35,103,https://votaciones.hcdn.gob.ar/diputado/933
935,1487,326,"LÓPEZ KOENIG, Leandro Gastón",342,91,4,38,475,https://votaciones.hcdn.gob.ar/diputado/326
936,1597,1613,"LÓPEZ, Juan Manuel",95,58,1,14,168,https://votaciones.hcdn.gob.ar/diputado/1613
937,1383,314,"LÓPEZ, Pablo Sebastián",150,244,79,17,490,https://votaciones.hcdn.gob.ar/diputado/314
938,542,919,"LÖFFLER, Ernesto Adrian",37,22,8,50,117,https://votaciones.hcdn.gob.ar/diputado/919
939,1385,270,"MAC ALLISTER, Carlos Javier",69,61,7,46,183,https://votaciones.hcdn.gob.ar/diputado/270
940,643,154,"MACALUSE, Eduardo Gabriel",600,376,97,155,1228,https://votaciones.hcdn.gob.ar/diputado/154
941,882,934,"MACCHI, Carlos Guillermo",158,70,15,455,698,https://votaciones.hcdn.gob.ar/diputado/934
942,144,1453,"MACEDO, Horacio Antonio",96,23,10,35,164,https://votaciones.hcdn.gob.ar/diputado/1453
943,1598,1668,"MACHA, Mónica",92,49,4,23,168,https://votaciones.hcdn.gob.ar/diputado/1668
944,145,1373,"MACHADO, Oscar Alfredo",54,49,5,70,178,https://votaciones.hcdn.gob.ar/diputado/1373
945,323,1374,"MACHICOTE, Jorge Raul",4,1,0,9,14,https://votaciones.hcdn.gob.ar/diputado/1374
946,988,935,"MACRI, Mauricio",40,26,2,406,474,https://votaciones.hcdn.gob.ar/diputado/935
947,1489,159,"MACÍAS, Oscar Alberto",261,28,9,177,475,https://votaciones.hcdn.gob.ar/diputado/159
948,1386,557,"MADERA, Teresita",406,24,10,50,490,https://votaciones.hcdn.gob.ar/diputado/557
949,644,936,"MAESTRO, Carlos",60,14,0,10,84,https://votaciones.hcdn.gob.ar/diputado/936
950,883,937,"MAFFEI, Marta Olinda",303,206,30,159,698,https://votaciones.hcdn.gob.ar/diputado/937
951,1387,533,"MAGARIO, Verónica María",177,4,0,2,183,https://votaciones.hcdn.gob.ar/diputado/533
952,324,1224,"MAGGI, Juan Alberto",7,0,0,7,14,https://votaciones.hcdn.gob.ar/diputado/1224
953,374,1454,"MAIDANA, Elsa H.",36,25,4,15,80,https://votaciones.hcdn.gob.ar/diputado/1454
954,1209,460,"MAJDALANI, Silvia Cristina",105,113,7,281,506,https://votaciones.hcdn.gob.ar/diputado/460
955,775,938,"MALDONADO, Aída Francisca",84,80,7,42,213,https://votaciones.hcdn.gob.ar/diputado/938
956,1294,221,"MALDONADO, Victor Hugo",69,93,11,234,407,https://votaciones.hcdn.gob.ar/diputado/221
957,146,1375,"MANFREDOTTI, Carlos",73,9,0,29,111,https://votaciones.hcdn.gob.ar/diputado/1375
958,325,1376,"MANNY, José Juan",4,1,0,9,14,https://votaciones.hcdn.gob.ar/diputado/1376
959,884,939,"MANSUR, Nélida Mabel",151,60,19,468,698,https://votaciones.hcdn.gob.ar/diputado/939
960,1210,69,"MANSUR, Ricardo Alfredo",67,7,0,25,99,https://votaciones.hcdn.gob.ar/diputado/69
961,645,940,"MANZOTTI, Mabel Gladys",56,19,1,8,84,https://votaciones.hcdn.gob.ar/diputado/940
962,147,1225,"MAQUEDA, Juan Carlos",134,31,1,43,209,https://votaciones.hcdn.gob.ar/diputado/1225
963,1490,341,"MAQUIEYRA, Martín",374,97,3,1,475,https://votaciones.hcdn.gob.ar/diputado/341
964,989,941,"MARCO DEL PONT, Mercedes",513,29,10,29,581,https://votaciones.hcdn.gob.ar/diputado/941
965,326,1377,"MARCO, Jorge Raúl",6,5,1,2,14,https://votaciones.hcdn.gob.ar/diputado/1377
966,148,1226,"MARCOLLI, Miguel",30,3,0,78,111,https://votaciones.hcdn.gob.ar/diputado/1226
967,885,210,"MARCONATO, Gustavo Angel",867,65,5,126,1063,https://votaciones.hcdn.gob.ar/diputado/210
968,990,942,"MARCONETTO, Aldo Juan",182,4,0,25,211,https://votaciones.hcdn.gob.ar/diputado/942
969,1388,376,"MARCOPULOS, Juan Fernando",171,7,0,5,183,https://votaciones.hcdn.gob.ar/diputado/376
970,149,1378,"MARCOS, Ricardo Ernesto",49,33,2,27,111,https://votaciones.hcdn.gob.ar/diputado/1378
971,1491,215,"MARCUCCI, Hugo María",375,92,3,5,475,https://votaciones.hcdn.gob.ar/diputado/215
972,327,943,"MARELLI, Mabel",56,40,1,34,131,https://votaciones.hcdn.gob.ar/diputado/943
973,991,945,"MARINO, Adriana del Cármen",240,43,19,530,832,https://votaciones.hcdn.gob.ar/diputado/945
974,328,944,"MARINO, Juliana Isabel",557,55,22,72,706,https://votaciones.hcdn.gob.ar/diputado/944
975,1599,1696,"MARTIARENA, José Luis",95,18,8,47,168,https://votaciones.hcdn.gob.ar/diputado/1696
976,1096,31,"MARTIARENA, Mario Humberto",289,25,4,47,365,https://votaciones.hcdn.gob.ar/diputado/31
977,329,1281,"MARTIN de DE NARDO, Marta",6,4,1,3,14,https://votaciones.hcdn.gob.ar/diputado/1281
978,1097,946,"MARTIN, María Elena",154,89,9,14,266,https://votaciones.hcdn.gob.ar/diputado/946
979,1144,947,"MARTINELLI, Guillermo Jesús",65,3,0,0,68,https://votaciones.hcdn.gob.ar/diputado/947
980,150,953,"MARTINEZ GARBINO, Emilio Raúl",287,101,17,624,1029,https://votaciones.hcdn.gob.ar/diputado/953
981,646,954,"MARTINEZ LLANO, José Rodolfo",9,22,2,132,165,https://votaciones.hcdn.gob.ar/diputado/954
982,1098,161,"MARTINEZ ODDONE, Heriberto Agustín",127,82,18,138,365,https://votaciones.hcdn.gob.ar/diputado/161
983,330,955,"MARTINEZ RAYMONDA, Rafael",99,61,15,38,213,https://votaciones.hcdn.gob.ar/diputado/955
984,441,1539,"MARTINEZ ZUCCARDI, Manuel A.",30,31,0,39,100,https://votaciones.hcdn.gob.ar/diputado/1539
985,776,948,"MARTINEZ, Alfredo",82,106,2,23,213,https://votaciones.hcdn.gob.ar/diputado/948
986,777,949,"MARTINEZ, Carlos Alberto",160,17,10,18,205,https://votaciones.hcdn.gob.ar/diputado/949
987,647,1195,"MARTINEZ, Enrique Mario",32,4,4,7,47,https://votaciones.hcdn.gob.ar/diputado/1195
988,1211,362,"MARTINEZ, Ernesto Félix",87,71,5,160,323,https://votaciones.hcdn.gob.ar/diputado/362
989,151,1455,"MARTINEZ, Esteban",72,19,0,73,164,https://votaciones.hcdn.gob.ar/diputado/1455
990,543,951,"MARTINEZ, Gerardo Alberto",27,39,1,50,117,https://votaciones.hcdn.gob.ar/diputado/951
991,886,183,"MARTINEZ, Julio César",443,252,49,460,1204,https://votaciones.hcdn.gob.ar/diputado/183
992,331,1186,"MARTINEZ, Luis Alberto",2,0,0,7,9,https://votaciones.hcdn.gob.ar/diputado/1186
993,152,952,"MARTINEZ, Manuel Luis",109,59,3,110,281,https://votaciones.hcdn.gob.ar/diputado/952
994,1295,268,"MARTINEZ, Oscar Ariel",203,40,7,157,407,https://votaciones.hcdn.gob.ar/diputado/268
995,153,950,"MARTINEZ, Silvia Virginia",279,83,11,121,494,https://votaciones.hcdn.gob.ar/diputado/950
996,887,956,"MARTINI, Hugo",211,111,38,338,698,https://votaciones.hcdn.gob.ar/diputado/956
997,686,1493,"MARTUCCI, Cesar",11,0,1,11,23,https://votaciones.hcdn.gob.ar/diputado/1493
998,1389,363,"MARTÍNEZ CAMPOS, Gustavo José",245,19,3,223,490,https://votaciones.hcdn.gob.ar/diputado/363
999,1492,406,"MARTÍNEZ VILLADA, Leonor María",334,84,7,50,475,https://votaciones.hcdn.gob.ar/diputado/406
1000,1493,560,"MARTÍNEZ, Ana Laura",249,31,1,26,307,https://votaciones.hcdn.gob.ar/diputado/560
1001,1494,307,"MARTÍNEZ, Darío",193,134,6,142,475,https://votaciones.hcdn.gob.ar/diputado/307
1002,1390,206,"MARTÍNEZ, Oscar Anselmo",251,98,5,136,490,https://votaciones.hcdn.gob.ar/diputado/206
1003,1495,534,"MARTÍNEZ, Silvia Alejandra",327,93,2,53,475,https://votaciones.hcdn.gob.ar/diputado/534
1004,1212,576,"MARTÍNEZ, Soledad",435,177,15,186,813,https://votaciones.hcdn.gob.ar/diputado/576
1005,1496,580,"MASIN, María Lucila",223,167,9,76,475,https://votaciones.hcdn.gob.ar/diputado/580
1006,1391,297,"MASSA, Sergio Tomás",193,20,3,274,490,https://votaciones.hcdn.gob.ar/diputado/297
1007,544,957,"MASSEI, Oscar Ermelindo",638,58,10,36,742,https://votaciones.hcdn.gob.ar/diputado/957
1008,1497,575,"MASSETANI, Vanesa Laura",371,33,19,52,475,https://votaciones.hcdn.gob.ar/diputado/575
1009,1498,254,"MASSO, Federico Augusto",212,64,9,22,307,https://votaciones.hcdn.gob.ar/diputado/254
1010,1499,336,"MASSOT, Nicolás María",343,97,7,28,475,https://votaciones.hcdn.gob.ar/diputado/336
1011,709,958,"MASTROGIACOMO, Miguel Angel",49,16,4,34,103,https://votaciones.hcdn.gob.ar/diputado/958
1012,154,1456,"MATHOV, Enrique José",40,53,1,70,164,https://votaciones.hcdn.gob.ar/diputado/1456
1013,1600,1641,"MATZEN, Lorena",103,49,1,15,168,https://votaciones.hcdn.gob.ar/diputado/1641
1014,155,959,"MATZKIN, Jorge Rubén",136,49,5,88,278,https://votaciones.hcdn.gob.ar/diputado/959
1015,442,1518,"MAURETTE, Fernando Wenceslao",64,24,0,12,100,https://votaciones.hcdn.gob.ar/diputado/1518
1016,545,960,"MAYANS, María Susana",37,44,0,36,117,https://votaciones.hcdn.gob.ar/diputado/960
1017,1392,405,"MAZURE, Liliana Amalia",254,112,2,122,490,https://votaciones.hcdn.gob.ar/diputado/405
1018,1213,419,"MAZZARELLA, Susana del Valle",117,76,7,123,323,https://votaciones.hcdn.gob.ar/diputado/419
1019,710,961,"MAZZEI, Hector Santiago",4,1,1,1,7,https://votaciones.hcdn.gob.ar/diputado/961
1020,1601,1687,"MEDINA, Gladys",69,9,3,87,168,https://votaciones.hcdn.gob.ar/diputado/1687
1021,1602,1646,"MEDINA, Martín Nicolás",97,60,0,11,168,https://votaciones.hcdn.gob.ar/diputado/1646
1022,888,962,"MEDIZA, Heriberto Eloy",516,35,8,139,698,https://votaciones.hcdn.gob.ar/diputado/962
1023,699,963,"MELILLO, Fernando Cesar",45,46,12,15,118,https://votaciones.hcdn.gob.ar/diputado/963
1024,443,1519,"MELOGNO, Elsa",66,22,0,12,100,https://votaciones.hcdn.gob.ar/diputado/1519
1025,778,964,"MENDEZ de FERREYRA, Araceli Estela",616,66,20,77,779,https://votaciones.hcdn.gob.ar/diputado/964
1026,546,965,"MENDEZ de MEDINA LAREU, Catalina",37,40,4,36,117,https://votaciones.hcdn.gob.ar/diputado/965
1027,156,1379,"MENDOZA, Claudio Ramiro",84,12,1,14,111,https://votaciones.hcdn.gob.ar/diputado/1379
1028,1603,1658,"MENDOZA, Josefina",93,48,0,27,168,https://votaciones.hcdn.gob.ar/diputado/1658
1029,157,1380,"MENDOZA, Martín",41,19,7,44,111,https://votaciones.hcdn.gob.ar/diputado/1380
1030,1296,577,"MENDOZA, Mayra Soledad",555,162,8,157,882,https://votaciones.hcdn.gob.ar/diputado/577
1031,1214,370,"MENDOZA, Sandra Marcela",447,71,2,293,813,https://votaciones.hcdn.gob.ar/diputado/370
1032,158,1282,"MENEGHINI, Javier Revnaldo",17,22,2,70,111,https://votaciones.hcdn.gob.ar/diputado/1282
1033,159,1460,"MENEM, Carlos Omar",101,25,1,37,164,https://votaciones.hcdn.gob.ar/diputado/1460
1034,648,966,"MENEM, Eduardo Adrián",225,99,32,507,863,https://votaciones.hcdn.gob.ar/diputado/966
1035,1604,1647,"MENNA, Gustavo",107,57,0,4,168,https://votaciones.hcdn.gob.ar/diputado/1647
1036,1215,283,"MERA, Dalmacio",46,21,1,31,99,https://votaciones.hcdn.gob.ar/diputado/283
1037,160,1461,"MERCADER, Martha Evelina",55,70,1,38,164,https://votaciones.hcdn.gob.ar/diputado/1461
1038,161,1457,"MERCADO LUNA, Ricardo Gastón",52,37,1,74,164,https://votaciones.hcdn.gob.ar/diputado/1457
1039,1500,540,"MERCADO, Verónica Elizabeth",230,146,9,90,475,https://votaciones.hcdn.gob.ar/diputado/540
1040,1099,539,"MERCHAN, Paula Cecilia",221,30,16,98,365,https://votaciones.hcdn.gob.ar/diputado/539
1041,889,967,"MERINO, Raul Guillermo",601,34,16,47,698,https://votaciones.hcdn.gob.ar/diputado/967
1042,547,968,"MERLO de RUIZ, María Celestina",33,25,0,59,117,https://votaciones.hcdn.gob.ar/diputado/968
1043,1100,40,"MERLO, Mario Raúl",157,60,14,134,365,https://votaciones.hcdn.gob.ar/diputado/40
1044,1393,325,"MESTRE, Diego Matías",412,152,14,80,658,https://votaciones.hcdn.gob.ar/diputado/325
1045,1297,144,"METAZA, Mario Alfredo",391,8,0,8,407,https://votaciones.hcdn.gob.ar/diputado/144
1046,649,969,"MEZA, Martha Elizabeth",25,27,2,69,123,https://votaciones.hcdn.gob.ar/diputado/969
1047,162,1283,"MICHELLI, Marco Aurelio",68,17,0,26,111,https://votaciones.hcdn.gob.ar/diputado/1283
1048,1216,511,"MICHETTI, Marta Gabriela",81,68,5,169,323,https://votaciones.hcdn.gob.ar/diputado/511
1049,163,1227,"MICHITTE, Salomón Antonio",67,9,1,34,111,https://votaciones.hcdn.gob.ar/diputado/1227
1050,164,1458,"MIGLIOZZI, Julio Alberto",108,22,2,32,164,https://votaciones.hcdn.gob.ar/diputado/1458
1051,650,970,"MILESI, Marta Silvia",90,21,2,52,165,https://votaciones.hcdn.gob.ar/diputado/970
1052,651,971,"MILLET, Juan Carlos",75,28,2,60,165,https://votaciones.hcdn.gob.ar/diputado/971
1053,1217,250,"MILMAN, Gerardo Fabián",130,67,7,119,323,https://votaciones.hcdn.gob.ar/diputado/250
1054,779,972,"MINGUEZ, Juan Jesús",87,110,6,10,213,https://votaciones.hcdn.gob.ar/diputado/972
1055,780,973,"MIRABILE, José Arnaldo",26,40,5,142,213,https://votaciones.hcdn.gob.ar/diputado/973
1056,165,974,"MIRALLES de ROMERO, Norma",141,59,3,78,281,https://votaciones.hcdn.gob.ar/diputado/974
1057,1501,200,"MIRANDA, Pedro Rubén",361,36,9,69,475,https://votaciones.hcdn.gob.ar/diputado/200
1058,1298,358,"MIRKIN, Beatriz Graciela",108,2,0,9,119,https://votaciones.hcdn.gob.ar/diputado/358
1059,781,975,"MOISES, Julio Carlos",48,21,1,11,81,https://votaciones.hcdn.gob.ar/diputado/975
1060,992,1679,"MOISÉS, María Carolina",492,43,20,445,1000,https://votaciones.hcdn.gob.ar/diputado/1679
1061,166,1381,"MOLARDO, Elvio Francisco",36,14,0,61,111,https://votaciones.hcdn.gob.ar/diputado/1381
1062,1218,136,"MOLAS, Pedro Omar",102,71,9,141,323,https://votaciones.hcdn.gob.ar/diputado/136
1063,1502,548,"MOLINA, Karina Alejandra",334,81,3,57,475,https://votaciones.hcdn.gob.ar/diputado/548
1064,782,977,"MOLINARI ROMERO, Luis",71,60,10,72,213,https://votaciones.hcdn.gob.ar/diputado/977
1065,167,1284,"MOLINAS, Ricardo Francisco",34,44,0,33,111,https://votaciones.hcdn.gob.ar/diputado/1284
1066,1605,1665,"MONALDI, Osmar",71,49,0,48,168,https://votaciones.hcdn.gob.ar/diputado/1665
1067,993,978,"MONAYAR, Ana María Cármen",488,33,4,67,592,https://votaciones.hcdn.gob.ar/diputado/978
1068,444,1520,"MONDELO, Lidia Elizabeth",55,18,4,23,100,https://votaciones.hcdn.gob.ar/diputado/1520
1069,445,1521,"MONDINO, Eduardo René",62,23,5,10,100,https://votaciones.hcdn.gob.ar/diputado/1521
1070,1503,266,"MONFORT, Marcelo Alejandro",346,90,7,32,475,https://votaciones.hcdn.gob.ar/diputado/266
1071,890,277,"MONGELO, José Ricardo",884,33,19,169,1105,https://votaciones.hcdn.gob.ar/diputado/277
1072,783,980,"MONTEAGUDO, María Lucrecia",31,102,15,65,213,https://votaciones.hcdn.gob.ar/diputado/980
1073,1606,1631,"MONTENEGRO, Guillermo Tristán",105,30,0,33,168,https://votaciones.hcdn.gob.ar/diputado/1631
1074,891,981,"MONTENEGRO, Olinda",231,161,13,293,698,https://votaciones.hcdn.gob.ar/diputado/981
1075,1101,982,"MONTERO, Laura Gisela",107,51,10,88,256,https://votaciones.hcdn.gob.ar/diputado/982
1076,332,1382,"MONTEVERDE, Carlos Roberto",8,1,0,5,14,https://votaciones.hcdn.gob.ar/diputado/1382
1077,892,983,"MONTI, Lucrecia Etelvina",380,34,14,270,698,https://votaciones.hcdn.gob.ar/diputado/983
1078,168,1459,"MONTIEL, Sergio Alberto",41,43,3,77,164,https://votaciones.hcdn.gob.ar/diputado/1459
1079,548,984,"MONTOYA, Fernando Ramón",71,61,9,189,330,https://votaciones.hcdn.gob.ar/diputado/984
1080,893,56,"MONTOYA, Jorge Luciano",243,37,4,308,592,https://votaciones.hcdn.gob.ar/diputado/56
1081,1504,240,"MONZÓ, Emilio",1,0,0,6,7,https://votaciones.hcdn.gob.ar/diputado/240
1082,1607,1667,"MORALES, Flavia",129,14,3,22,168,https://votaciones.hcdn.gob.ar/diputado/1667
1083,1505,588,"MORALES, Mariana Elizabet",301,21,9,144,475,https://votaciones.hcdn.gob.ar/diputado/588
1084,784,985,"MORALES, Nélida Beatriz",55,51,12,95,213,https://votaciones.hcdn.gob.ar/diputado/985
1085,1102,377,"MORAN, Juan Carlos",150,89,27,99,365,https://votaciones.hcdn.gob.ar/diputado/377
1086,994,986,"MORANDINI, Norma Elena",331,93,112,296,832,https://votaciones.hcdn.gob.ar/diputado/986
1087,1103,202,"MORANTE, Antonio Arnaldo María",292,29,1,43,365,https://votaciones.hcdn.gob.ar/diputado/202
1088,923,987,"MORAY, Hector Luis",13,0,1,18,32,https://votaciones.hcdn.gob.ar/diputado/987
1089,1506,562,"MOREAU, Cecilia",301,38,11,125,475,https://votaciones.hcdn.gob.ar/diputado/562
1090,169,1672,"MOREAU, Leopoldo Raúl Guido",170,134,13,175,492,https://votaciones.hcdn.gob.ar/diputado/1672
1091,1104,46,"MOREJON, Manuel Amor",274,16,6,69,365,https://votaciones.hcdn.gob.ar/diputado/46
1092,170,1452,"MORELLO, Emilio Pedro",29,35,3,97,164,https://votaciones.hcdn.gob.ar/diputado/1452
1093,549,989,"MORENO RAMIREZ, Arturo Jorge",22,45,7,43,117,https://votaciones.hcdn.gob.ar/diputado/989
1094,995,14,"MORENO, Carlos Julio",1232,177,17,219,1645,https://votaciones.hcdn.gob.ar/diputado/14
1095,1105,990,"MORGADO, Claudio Marcelo",278,15,14,27,334,https://votaciones.hcdn.gob.ar/diputado/990
1096,996,991,"MORINI, Pedro Juan",431,198,21,182,832,https://votaciones.hcdn.gob.ar/diputado/991
1097,1608,1678,"MOSQUEDA, Juan",71,9,1,87,168,https://votaciones.hcdn.gob.ar/diputado/1678
1098,446,1522,"MOSSELLO de BENZO, María",60,18,7,15,100,https://votaciones.hcdn.gob.ar/diputado/1522
1099,550,992,"MOSSO, Ana Maria",43,43,9,22,117,https://votaciones.hcdn.gob.ar/diputado/992
1100,447,1568,"MOTHE, Felix Arturo",29,21,1,49,100,https://votaciones.hcdn.gob.ar/diputado/1568
1101,1219,6,"MOUILLERON, Roberto Mario",183,67,12,61,323,https://votaciones.hcdn.gob.ar/diputado/6
1102,333,1383,"MOURE, Juan Manuel",3,0,0,11,14,https://votaciones.hcdn.gob.ar/diputado/1383
1103,551,993,"MOURIÑO, Javier",45,36,0,36,117,https://votaciones.hcdn.gob.ar/diputado/993
1104,1299,337,"MOYANO, Juan Facundo",496,109,16,261,882,https://votaciones.hcdn.gob.ar/diputado/337
1105,652,994,"MUKDISE, Miguel Roberto Daives",99,31,3,32,165,https://votaciones.hcdn.gob.ar/diputado/994
1106,1300,25,"MULLER, Edgar Raúl",75,68,11,253,407,https://votaciones.hcdn.gob.ar/diputado/25
1107,171,392,"MULLER, Mabel Hilda",851,142,18,326,1337,https://votaciones.hcdn.gob.ar/diputado/392
1108,172,1384,"MUNIAGURRIA, Marcelo Julio",71,9,3,28,111,https://votaciones.hcdn.gob.ar/diputado/1384
1109,173,1462,"MURIEL, Nestor Jorge",49,17,3,95,164,https://votaciones.hcdn.gob.ar/diputado/1462
1110,448,996,"MUSSA, Laura Cristina",74,108,21,110,313,https://votaciones.hcdn.gob.ar/diputado/996
1111,653,1491,"MUSSI, Juan José",0,0,0,25,25,https://votaciones.hcdn.gob.ar/diputado/1491
1112,174,1385,"MUÑOZ, Marcelo Bernardo",20,25,7,59,111,https://votaciones.hcdn.gob.ar/diputado/1385
1113,1609,1695,"MUÑOZ, Rosa Rosario",111,23,11,23,168,https://votaciones.hcdn.gob.ar/diputado/1695
1114,175,1228,"NACUL, Miguel Camel",70,10,0,31,111,https://votaciones.hcdn.gob.ar/diputado/1228
1115,1029,997,"NAIM, Lidia Lucía",263,99,23,269,654,https://votaciones.hcdn.gob.ar/diputado/997
1116,1610,1637,"NAJUL, Claudia Inés",105,58,1,4,168,https://votaciones.hcdn.gob.ar/diputado/1637
1117,1507,319,"NANNI, Miguel",324,85,2,64,475,https://votaciones.hcdn.gob.ar/diputado/319
1118,785,998,"NARDUCCI, Alicia Isabel",147,19,1,46,213,https://votaciones.hcdn.gob.ar/diputado/998
1119,176,999,"NATALE, Alberto Adolfo",137,152,62,156,507,https://votaciones.hcdn.gob.ar/diputado/999
1120,1301,466,"NAVARRO, Graciela",615,41,1,225,882,https://votaciones.hcdn.gob.ar/diputado/466
1121,1508,459,"NAZARIO, Adriana Mónica",276,25,13,161,475,https://votaciones.hcdn.gob.ar/diputado/459
1122,1220,393,"NEBREDA, Carmen Rosa",268,25,1,29,323,https://votaciones.hcdn.gob.ar/diputado/393
1123,1611,1617,"NEDER, Estela Mary",152,20,1,35,208,https://votaciones.hcdn.gob.ar/diputado/1617
1124,177,1463,"NEDER, Jorge Humberto",63,44,2,55,164,https://votaciones.hcdn.gob.ar/diputado/1463
1125,178,101,"NEGRI, Mario Raúl",712,397,49,703,1861,https://votaciones.hcdn.gob.ar/diputado/101
1126,552,1001,"NEME-SCHEIJ, Alfredo",59,19,1,38,117,https://votaciones.hcdn.gob.ar/diputado/1001
1127,894,1002,"NEMIROVSCI, Osvaldo Mario",523,35,6,134,698,https://votaciones.hcdn.gob.ar/diputado/1002
1128,786,1003,"NERI, Aldo",73,87,7,46,213,https://votaciones.hcdn.gob.ar/diputado/1003
1129,334,1386,"NICKISCH, Hugo Victor",6,1,0,7,14,https://votaciones.hcdn.gob.ar/diputado/1386
1130,553,1004,"NICOTRA, Norberto Reynaldo",45,37,3,32,117,https://votaciones.hcdn.gob.ar/diputado/1004
1131,654,1005,"NIETO BRIZUELA, Benjamín Ricardo",105,37,3,20,165,https://votaciones.hcdn.gob.ar/diputado/1005
1132,179,1006,"NIEVA, Alejandro Mario",496,320,21,380,1217,https://votaciones.hcdn.gob.ar/diputado/1006
1133,180,1387,"NIÑO, Jorge",54,9,0,48,111,https://votaciones.hcdn.gob.ar/diputado/1387
1134,655,1007,"NOFAL, Beatriz",52,18,8,6,84,https://votaciones.hcdn.gob.ar/diputado/1007
1135,181,1285,"NOVAU, Pedro José",43,41,2,25,111,https://votaciones.hcdn.gob.ar/diputado/1285
1136,1509,309,"NUÑEZ, José Carlos",336,98,3,38,475,https://votaciones.hcdn.gob.ar/diputado/309
1137,449,1569,"OBARRIO, Luis Manuel",61,19,0,20,100,https://votaciones.hcdn.gob.ar/diputado/1569
1138,656,68,"OBEID, Jorge Alberto",226,84,16,204,530,https://votaciones.hcdn.gob.ar/diputado/68
1139,1106,317,"OBIGLIO, Julián Martín",256,188,8,183,635,https://votaciones.hcdn.gob.ar/diputado/317
1140,450,1570,"OCAMPOS, Jorge Armando",39,25,3,33,100,https://votaciones.hcdn.gob.ar/diputado/1570
1141,657,477,"OCAÑA, Maria Graciela",200,155,19,493,867,https://votaciones.hcdn.gob.ar/diputado/477
1142,451,1524,"OLIMA, Juan Carlos",52,21,2,25,100,https://votaciones.hcdn.gob.ar/diputado/1524
1143,997,269,"OLIVA, Cristian Rodolfo",1024,49,50,522,1645,https://votaciones.hcdn.gob.ar/diputado/269
1144,1394,116,"OLIVARES, Héctor Enrique",429,152,15,62,658,https://votaciones.hcdn.gob.ar/diputado/116
1145,182,1286,"OLIVERA, Enrique José",28,52,8,23,111,https://votaciones.hcdn.gob.ar/diputado/1286
1146,658,1009,"OLIVERO, Juan Carlos",100,41,3,21,165,https://votaciones.hcdn.gob.ar/diputado/1009
1147,1612,1689,"OLIVETO LAGO, Paula Mariana",106,59,1,2,168,https://votaciones.hcdn.gob.ar/diputado/1689
1148,1221,239,"OLMEDO, Alfredo Horacio",369,116,12,301,798,https://votaciones.hcdn.gob.ar/diputado/239
1149,895,1010,"OLMOS, Graciela Hortencia",534,43,14,107,698,https://votaciones.hcdn.gob.ar/diputado/1010
1150,1302,350,"OPORTO, Mario Néstor",397,8,1,1,407,https://votaciones.hcdn.gob.ar/diputado/350
1151,1510,212,"ORELLANA, José Fernando",263,17,17,178,475,https://votaciones.hcdn.gob.ar/diputado/212
1152,183,1388,"ORGAZ, Alfredo",17,22,0,72,111,https://votaciones.hcdn.gob.ar/diputado/1388
1153,659,1011,"OROZCO, Jorge Alberto",36,18,4,4,62,https://votaciones.hcdn.gob.ar/diputado/1011
1154,184,1287,"ORQUIN, Leopoldo Manuel",27,37,1,46,111,https://votaciones.hcdn.gob.ar/diputado/1287
1155,1222,109,"ORSOLINI, Pablo Eduardo",153,84,2,84,323,https://votaciones.hcdn.gob.ar/diputado/109
1156,554,1012,"ORTEGA, Marta Isabel",40,26,0,51,117,https://votaciones.hcdn.gob.ar/diputado/1012
1157,1303,551,"ORTIZ CORREA, Marcia Sara María",366,10,1,30,407,https://votaciones.hcdn.gob.ar/diputado/551
1158,185,1288,"ORTIZ MALDONADO, Gastón H.",39,27,1,44,111,https://votaciones.hcdn.gob.ar/diputado/1288
1159,335,1389,"ORTIZ PELLEGRINI, Miguel A.",7,0,0,7,14,https://votaciones.hcdn.gob.ar/diputado/1389
1160,1304,537,"ORTIZ, Mariela",377,9,1,20,407,https://votaciones.hcdn.gob.ar/diputado/537
1161,998,1013,"OSCOS, María Ilse",25,26,5,135,191,https://votaciones.hcdn.gob.ar/diputado/1013
1162,787,1014,"OSORIO, Marta Lucía",888,60,37,57,1042,https://votaciones.hcdn.gob.ar/diputado/1014
1163,788,1015,"OSTROPOLSKY, Aldo Hector",47,22,4,8,81,https://votaciones.hcdn.gob.ar/diputado/1015
1164,789,1016,"OSUNA, Blanca Inés",589,34,25,131,779,https://votaciones.hcdn.gob.ar/diputado/1016
1165,660,1017,"OVIEDO, Alejandra Beatriz",216,109,29,509,863,https://votaciones.hcdn.gob.ar/diputado/1017
1166,1107,117,"PAIS, Juan Mario",712,39,4,17,772,https://votaciones.hcdn.gob.ar/diputado/117
1167,790,1018,"PALOMO, Nelida Manuela",154,23,5,23,205,https://votaciones.hcdn.gob.ar/diputado/1018
1168,661,1019,"PALOU, Marta",70,54,1,40,165,https://votaciones.hcdn.gob.ar/diputado/1019
1169,662,1020,"PAMPURO, José Juan Bautista",7,27,2,48,84,https://votaciones.hcdn.gob.ar/diputado/1020
1170,452,1571,"PANDO, Ana María",51,36,1,12,100,https://votaciones.hcdn.gob.ar/diputado/1571
1171,1223,248,"PANSA, Sergio Horacio",150,57,1,115,323,https://votaciones.hcdn.gob.ar/diputado/248
1172,896,1021,"PANZONI, Patricia Ester",189,169,11,329,698,https://votaciones.hcdn.gob.ar/diputado/1021
1173,186,1390,"PARADA, Alberto",80,15,3,13,111,https://votaciones.hcdn.gob.ar/diputado/1390
1174,1224,441,"PARADA, Liliana Beatriz",115,66,25,117,323,https://votaciones.hcdn.gob.ar/diputado/441
1175,187,1478,"PARAJON, José María",38,38,3,85,164,https://votaciones.hcdn.gob.ar/diputado/1478
1176,1108,375,"PAREDES URQUIZA, Alberto Nicolás",178,29,6,152,365,https://votaciones.hcdn.gob.ar/diputado/375
1177,336,1289,"PARENTE, Rodolfo Miguel",8,6,0,0,14,https://votaciones.hcdn.gob.ar/diputado/1289
1178,453,1022,"PARENTELLA, Irma Fidela",132,90,17,26,265,https://votaciones.hcdn.gob.ar/diputado/1022
1179,188,1391,"PAROLA, José María",42,19,2,48,111,https://votaciones.hcdn.gob.ar/diputado/1391
1180,1109,122,"PAROLI, Raúl Omar",217,38,3,107,365,https://votaciones.hcdn.gob.ar/diputado/122
1181,454,1607,"PARRA, Nelida del Carmen",45,15,3,4,67,https://votaciones.hcdn.gob.ar/diputado/1607
1182,337,1229,"PARRILLI, Oscar Isidro José",4,0,0,10,14,https://votaciones.hcdn.gob.ar/diputado/1229
1183,663,1024,"PASCUAL, Jorge Raul",105,40,3,17,165,https://votaciones.hcdn.gob.ar/diputado/1024
1184,189,1023,"PASCUAL, Rafael Manuel",59,69,3,71,202,https://votaciones.hcdn.gob.ar/diputado/1023
1185,455,1608,"PASCUALINI de ACOSTA, Elida E.",39,18,8,12,77,https://votaciones.hcdn.gob.ar/diputado/1608
1186,1110,292,"PASINI, Ariel Osvaldo",362,32,4,21,419,https://votaciones.hcdn.gob.ar/diputado/292
1187,456,1025,"PASSO, Juan Carlos",97,50,0,37,184,https://votaciones.hcdn.gob.ar/diputado/1025
1188,1511,558,"PASSO, Marcela Fabiana",282,37,13,143,475,https://votaciones.hcdn.gob.ar/diputado/558
1189,1396,86,"PASTORI, Luis Mario",464,164,13,17,658,https://votaciones.hcdn.gob.ar/diputado/86
1190,999,1026,"PASTORIZA, Eduardo Antonio",326,32,2,472,832,https://votaciones.hcdn.gob.ar/diputado/1026
1191,1111,385,"PASTORIZA, Mirta Ameliana",942,49,22,234,1247,https://votaciones.hcdn.gob.ar/diputado/385
1192,1512,220,"PATIÑO, José Luis",264,41,2,0,307,https://votaciones.hcdn.gob.ar/diputado/220
1193,190,1027,"PATTERSON, Ricardo Ancell",134,51,6,134,325,https://votaciones.hcdn.gob.ar/diputado/1027
1194,1397,171,"PEDRINI, Juan Manuel",315,132,7,36,490,https://votaciones.hcdn.gob.ar/diputado/171
1195,191,1028,"PELAEZ, Victor",149,91,1,88,329,https://votaciones.hcdn.gob.ar/diputado/1028
1196,192,1464,"PELLIN, Osvaldo Francisco",81,36,1,46,164,https://votaciones.hcdn.gob.ar/diputado/1464
1197,193,1029,"PEPE, Lorenzo Antonio",191,59,7,119,376,https://votaciones.hcdn.gob.ar/diputado/1029
1198,194,1392,"PERALTA, Anibal Pedro",32,10,4,65,111,https://votaciones.hcdn.gob.ar/diputado/1392
1199,1112,262,"PERALTA, Fabián Francisco",311,206,24,231,772,https://votaciones.hcdn.gob.ar/diputado/262
1200,457,1540,"PEREYRA de MONTENEGRO, María",32,27,0,41,100,https://votaciones.hcdn.gob.ar/diputado/1540
1201,1113,351,"PEREYRA, Guillermo Antonio",257,24,1,83,365,https://votaciones.hcdn.gob.ar/diputado/351
1202,1513,26,"PEREYRA, Juan Manuel",185,97,5,188,475,https://votaciones.hcdn.gob.ar/diputado/26
1203,791,1034,"PEREZ  MARTINEZ, Claudio Héctor",76,74,5,58,213,https://votaciones.hcdn.gob.ar/diputado/1034
1204,792,1035,"PEREZ SUAREZ, Inés",53,91,12,45,201,https://votaciones.hcdn.gob.ar/diputado/1035
1205,897,1032,"PEREZ, Alberto Cesar",53,23,2,620,698,https://votaciones.hcdn.gob.ar/diputado/1032
1206,1032,345,"PEREZ, Alberto José",164,77,14,112,367,https://votaciones.hcdn.gob.ar/diputado/345
1207,1114,18,"PEREZ, Jorge Raúl",275,35,7,39,356,https://votaciones.hcdn.gob.ar/diputado/18
1208,195,1030,"PEREZ, Jorge Telmo",97,44,2,138,281,https://votaciones.hcdn.gob.ar/diputado/1030
1209,898,1033,"PEREZ, José Adrián",426,307,61,408,1202,https://votaciones.hcdn.gob.ar/diputado/1033
1210,899,1031,"PEREZ, Mirta",476,64,34,124,698,https://votaciones.hcdn.gob.ar/diputado/1031
1211,900,32,"PERIE, Hugo Rubén",791,63,4,194,1052,https://votaciones.hcdn.gob.ar/diputado/32
1212,1115,442,"PERIE, Julia Argentina",666,37,5,64,772,https://votaciones.hcdn.gob.ar/diputado/442
1213,196,1036,"PERNASETTI, Horacio Francisco",209,171,13,101,494,https://votaciones.hcdn.gob.ar/diputado/1036
1214,1305,156,"PEROTTI, Omar Angel",345,6,2,54,407,https://votaciones.hcdn.gob.ar/diputado/156
1215,197,1465,"PERRINI, Gioconda Eulalia",112,19,3,30,164,https://votaciones.hcdn.gob.ar/diputado/1465
1216,1306,356,"PERRONI, Ana María",406,10,1,1,418,https://votaciones.hcdn.gob.ar/diputado/356
1217,1613,1674,"PERTILE, Elda",103,9,7,49,168,https://votaciones.hcdn.gob.ar/diputado/1674
1218,198,1290,"PESCE, Felix",70,12,3,26,111,https://votaciones.hcdn.gob.ar/diputado/1290
1219,901,1037,"PESO, Stella Marys",333,63,37,265,698,https://votaciones.hcdn.gob.ar/diputado/1037
1220,1116,1038,"PETIT, María de los Angeles",134,36,7,89,266,https://votaciones.hcdn.gob.ar/diputado/1038
1221,1399,321,"PETRI, Luis Alfonso",434,160,19,45,658,https://votaciones.hcdn.gob.ar/diputado/321
1222,664,1039,"PEYROU, Alejandro Apolinario",53,19,0,12,84,https://votaciones.hcdn.gob.ar/diputado/1039
1223,458,1572,"PEZOA, Juan Carlos",68,18,1,13,100,https://votaciones.hcdn.gob.ar/diputado/1572
1224,1515,595,"PEÑALOZA MARIANETTI, María Florencia",322,25,3,114,464,https://votaciones.hcdn.gob.ar/diputado/595
1225,665,1040,"PICAZO, Sarah Ana",95,38,6,26,165,https://votaciones.hcdn.gob.ar/diputado/1040
1226,793,1041,"PICCININI, Alberto José",33,51,15,114,213,https://votaciones.hcdn.gob.ar/diputado/1041
1227,199,1393,"PICCININI, Ana Ida",28,14,4,65,111,https://votaciones.hcdn.gob.ar/diputado/1393
1228,1614,1661,"PICCOLOMINI, María Carla",103,59,1,5,168,https://votaciones.hcdn.gob.ar/diputado/1661
1229,200,1042,"PICHETTO, Miguel Angel",164,79,3,35,281,https://votaciones.hcdn.gob.ar/diputado/1042
1230,1225,204,"PIEMONTE, Héctor Horacio",120,77,12,114,323,https://votaciones.hcdn.gob.ar/diputado/204
1231,201,1043,"PIERRI, Alberto Reinaldo",14,20,0,122,156,https://votaciones.hcdn.gob.ar/diputado/1043
1232,1307,322,"PIETRAGALLA CORTI, Horacio",487,41,7,40,575,https://votaciones.hcdn.gob.ar/diputado/322
1233,794,1044,"PILATI, Norma Raquel",179,20,3,11,213,https://votaciones.hcdn.gob.ar/diputado/1044
1234,1226,461,"PILATTI VERGARA, María Inés",279,24,1,19,323,https://votaciones.hcdn.gob.ar/diputado/461
1235,555,1045,"PINCHETTI de SIERRA MORALES, Delia Norma",28,27,1,61,117,https://votaciones.hcdn.gob.ar/diputado/1045
1236,902,123,"PINEDO, Federico",526,340,43,561,1470,https://votaciones.hcdn.gob.ar/diputado/123
1237,556,1046,"PINTO BRUCHMANN, Juan Domingo",194,57,8,71,330,https://votaciones.hcdn.gob.ar/diputado/1046
1238,202,1291,"PINTO, Guillermo",16,17,1,77,111,https://votaciones.hcdn.gob.ar/diputado/1291
1239,1153,189,"PINTO, Sergio Damián",86,10,1,12,109,https://votaciones.hcdn.gob.ar/diputado/189
1240,203,1230,"PIOTTI, Alberto Daniel",26,1,0,6,33,https://votaciones.hcdn.gob.ar/diputado/1230
1241,459,1573,"PIRIZ, Juan Carlos",38,7,0,55,100,https://votaciones.hcdn.gob.ar/diputado/1573
1242,1516,553,"PITIOT, Carla Betina",355,36,14,70,475,https://votaciones.hcdn.gob.ar/diputado/553
1243,1400,87,"PITROLA, Néstor Antonio",95,171,56,24,346,https://votaciones.hcdn.gob.ar/diputado/87
1244,1154,1047,"PIUMATO, Julio Juán",94,1,1,4,100,https://votaciones.hcdn.gob.ar/diputado/1047
1245,460,1574,"PIÑON AVILA, Celia Isabel",40,37,1,22,100,https://votaciones.hcdn.gob.ar/diputado/1574
1246,1227,93,"PLAINI, Francisco Omar",328,123,6,356,813,https://votaciones.hcdn.gob.ar/diputado/93
1247,903,214,"POGGI, Claudio Javier",417,177,52,525,1171,https://votaciones.hcdn.gob.ar/diputado/214
1248,204,1049,"POLINO, Hector Teodoro",152,213,38,91,494,https://votaciones.hcdn.gob.ar/diputado/1049
1249,1615,1684,"POLLEDO, Carmen",107,60,1,0,168,https://votaciones.hcdn.gob.ar/diputado/1684
1250,205,1474,"POLO, Luis Nicolas",49,54,2,59,164,https://votaciones.hcdn.gob.ar/diputado/1474
1251,1117,143,"PORTELA, Agustín Alberto",219,168,19,366,772,https://votaciones.hcdn.gob.ar/diputado/143
1252,1000,1050,"PORTO, Héctor Norberto",568,47,7,210,832,https://votaciones.hcdn.gob.ar/diputado/1050
1253,795,1051,"POSSE, Melchor Angel",13,13,2,56,84,https://votaciones.hcdn.gob.ar/diputado/1051
1254,1308,114,"PRADINES, Roberto Arturo",124,150,14,119,407,https://votaciones.hcdn.gob.ar/diputado/114
1255,206,1292,"PRAT, Alfredo Ernesto",25,39,3,44,111,https://votaciones.hcdn.gob.ar/diputado/1292
1256,1517,236,"PRETTO, Pedro Javier",353,95,7,20,475,https://votaciones.hcdn.gob.ar/diputado/236
1257,1118,124,"PRIETO, Hugo Nelson",250,29,8,78,365,https://votaciones.hcdn.gob.ar/diputado/124
1258,338,1394,"PROFILI, Gerardo Pedro",5,5,0,4,14,https://votaciones.hcdn.gob.ar/diputado/1394
1259,339,1293,"PRONE, Alberto Josue",6,2,0,6,14,https://votaciones.hcdn.gob.ar/diputado/1293
1260,461,1052,"PRUYAS, Tomás Rubén",225,39,2,34,300,https://votaciones.hcdn.gob.ar/diputado/1052
1261,1309,509,"PUCHETA, Ramona",247,58,5,97,407,https://votaciones.hcdn.gob.ar/diputado/509
1262,666,66,"PUERTA, Federico Ramón",55,62,2,288,407,https://votaciones.hcdn.gob.ar/diputado/66
1263,796,1053,"PUIG de STUBRIN, Lilia",76,111,6,20,213,https://votaciones.hcdn.gob.ar/diputado/1053
1264,557,386,"PUIGGROS, Adriana Victoria",733,55,7,72,867,https://votaciones.hcdn.gob.ar/diputado/386
1265,340,1395,"PURICELLI, Arturo Antonio",3,1,0,10,14,https://votaciones.hcdn.gob.ar/diputado/1395
1266,1398,330,"PÉREZ, Martín Alejandro",387,151,9,111,658,https://votaciones.hcdn.gob.ar/diputado/330
1267,1514,127,"PÉREZ, Raúl Joaquín",256,29,8,182,475,https://votaciones.hcdn.gob.ar/diputado/127
1268,1616,1670,"QUETGLAS, Fabio José",78,54,0,36,168,https://votaciones.hcdn.gob.ar/diputado/1670
1269,341,1294,"QUEZADA, Rodolfo H.",4,6,0,4,14,https://votaciones.hcdn.gob.ar/diputado/1294
1270,1548,29,"QUINTAR, Amado",3,2,0,181,186,https://votaciones.hcdn.gob.ar/diputado/29
1271,558,1054,"QUINTELA, Ricardo Clemente",85,66,3,44,198,https://votaciones.hcdn.gob.ar/diputado/1054
1272,1155,401,"QUINTERO, Marta Beatriz",72,21,4,15,112,https://votaciones.hcdn.gob.ar/diputado/401
1273,559,1192,"QUINZIO, Bernardo Pascual",34,42,0,19,95,https://votaciones.hcdn.gob.ar/diputado/1192
1274,1228,108,"QUIROGA, Horacio Rodolfo",54,8,1,27,90,https://votaciones.hcdn.gob.ar/diputado/108
1275,667,410,"QUIROZ, Elsa Siria",548,310,52,186,1096,https://votaciones.hcdn.gob.ar/diputado/410
1276,1518,579,"RACH QUIROGA, Analía Alexandra",209,139,5,122,475,https://votaciones.hcdn.gob.ar/diputado/579
1277,1519,4,"RAFFO, Julio César",197,13,1,96,307,https://votaciones.hcdn.gob.ar/diputado/4
1278,342,149,"RAIMUNDI, Carlos",732,234,50,502,1518,https://votaciones.hcdn.gob.ar/diputado/149
1279,1520,313,"RAMOS, Alejandro Ariel",208,125,5,137,475,https://votaciones.hcdn.gob.ar/diputado/313
1280,462,1575,"RAMPI, Pascual Angel",61,21,1,17,100,https://votaciones.hcdn.gob.ar/diputado/1575
1281,1617,1589,"RAMÓN, José Luis",134,26,6,2,168,https://votaciones.hcdn.gob.ar/diputado/1589
1282,797,1056,"RAPETTI, Ricardo Francisco",38,14,2,158,212,https://votaciones.hcdn.gob.ar/diputado/1056
1283,1310,361,"RASINO, Elida Elena",116,90,14,187,407,https://votaciones.hcdn.gob.ar/diputado/361
1284,798,1057,"RATTIN, Antonio Ubaldo",40,29,10,134,213,https://votaciones.hcdn.gob.ar/diputado/1057
1285,1618,1677,"RAUSCHENBERGER, Ariel",132,11,5,20,168,https://votaciones.hcdn.gob.ar/diputado/1677
1286,1521,563,"RAVERTA, María Fernanda",241,163,12,59,475,https://votaciones.hcdn.gob.ar/diputado/563
1287,1229,440,"RE, Hilma Leonor",89,71,9,154,323,https://votaciones.hcdn.gob.ar/diputado/440
1288,207,1231,"RE, Ricardo Horacio",78,16,0,17,111,https://votaciones.hcdn.gob.ar/diputado/1231
1289,1001,1,"RECALDE, Héctor Pedro",1276,177,12,180,1645,https://votaciones.hcdn.gob.ar/diputado/1
1290,560,1058,"RECIO, Jose  Antonio",62,23,0,22,107,https://votaciones.hcdn.gob.ar/diputado/1058
1291,1311,349,"REDCZUK, Oscar Felipe",322,11,0,74,407,https://votaciones.hcdn.gob.ar/diputado/349
1292,1230,397,"REGAZZOLI, María Cristina",299,23,0,1,323,https://votaciones.hcdn.gob.ar/diputado/397
1293,1619,1621,"REGIDOR BELLEDONE, Estela Mercedes",82,57,0,29,168,https://votaciones.hcdn.gob.ar/diputado/1621
1294,1119,1059,"REJAL, Jesús Fernando",118,5,1,129,253,https://votaciones.hcdn.gob.ar/diputado/1059
1295,493,1596,"REMEDI, Luz Elizabeth",19,10,4,21,54,https://votaciones.hcdn.gob.ar/diputado/1596
1296,561,1060,"REMES LENICOV, Jorge Luis",39,51,1,27,118,https://votaciones.hcdn.gob.ar/diputado/1060
1297,1120,568,"REYES, María Fernanda",149,87,9,120,365,https://votaciones.hcdn.gob.ar/diputado/568
1298,1620,1652,"REYES, Roxana Nahir",108,58,1,1,168,https://votaciones.hcdn.gob.ar/diputado/1652
1299,668,1061,"RIAL, Osvaldo Hugo",57,51,7,50,165,https://votaciones.hcdn.gob.ar/diputado/1061
1300,1401,186,"RICCARDO, José Luis",402,132,13,111,658,https://votaciones.hcdn.gob.ar/diputado/186
1301,1648,1713,"RICCI, Nadia Lorena",60,43,0,26,129,https://votaciones.hcdn.gob.ar/diputado/1713
1302,904,1062,"RICHTER, Ana",554,37,6,101,698,https://votaciones.hcdn.gob.ar/diputado/1062
1303,208,1475,"RICO, Aldo",33,39,1,80,153,https://votaciones.hcdn.gob.ar/diputado/1475
1304,799,1063,"RICO, María del Carmen Cecilia",585,91,60,309,1045,https://votaciones.hcdn.gob.ar/diputado/1063
1305,1312,24,"RIESTRA, Antonio Sabino",203,95,24,85,407,https://votaciones.hcdn.gob.ar/diputado/24
1306,1121,483,"RIOBOO, Sandra Adriana",107,61,14,183,365,https://votaciones.hcdn.gob.ar/diputado/483
1307,1313,424,"RIOS, Liliana María",359,6,0,42,407,https://votaciones.hcdn.gob.ar/diputado/424
1308,905,1064,"RIOS, María Fabiana",187,182,21,308,698,https://votaciones.hcdn.gob.ar/diputado/1064
1309,1314,216,"RIOS, Roberto Fabián",172,4,0,48,224,https://votaciones.hcdn.gob.ar/diputado/216
1310,1231,513,"RISKO, Silvia Lucrecia",567,54,5,187,813,https://votaciones.hcdn.gob.ar/diputado/513
1311,1522,456,"RISTA, Olga María",321,90,4,60,475,https://votaciones.hcdn.gob.ar/diputado/456
1312,906,1065,"RITONDO, Cristian",176,50,20,452,698,https://votaciones.hcdn.gob.ar/diputado/1065
1313,463,1576,"RIVADERA, Marta Liliana",40,14,2,44,100,https://votaciones.hcdn.gob.ar/diputado/1576
1314,1232,8,"RIVARA, Raúl Alberto",138,56,8,121,323,https://votaciones.hcdn.gob.ar/diputado/8
1315,1315,96,"RIVAROLA, Rubén Armando",284,4,1,118,407,https://votaciones.hcdn.gob.ar/diputado/96
1316,562,195,"RIVAS, Jorge",465,186,37,257,945,https://votaciones.hcdn.gob.ar/diputado/195
1317,669,1066,"RIVAS, Olijela del Valle",54,50,5,56,165,https://votaciones.hcdn.gob.ar/diputado/1066
1318,1316,131,"ROBERTI, Alberto Oscar",111,48,29,611,799,https://votaciones.hcdn.gob.ar/diputado/131
1319,464,1597,"ROBERTI, Raquel",30,18,1,18,67,https://votaciones.hcdn.gob.ar/diputado/1597
1320,1233,89,"ROBLEDO, Roberto Ricardo",257,23,2,41,323,https://votaciones.hcdn.gob.ar/diputado/89
1321,711,1067,"ROBLES AVALOS, Edmundo Eduardo",10,3,0,9,22,https://votaciones.hcdn.gob.ar/diputado/1067
1322,465,1525,"ROBLES, Miguel Angel",62,18,0,20,100,https://votaciones.hcdn.gob.ar/diputado/1525
1323,1621,1640,"RODENAS, Alejandra",71,40,6,51,168,https://votaciones.hcdn.gob.ar/diputado/1640
1324,466,1068,"RODIL, Rodolfo",137,74,19,31,261,https://votaciones.hcdn.gob.ar/diputado/1068
1325,209,1295,"RODRIGO, Esteban Joaquin",42,15,2,52,111,https://votaciones.hcdn.gob.ar/diputado/1295
1326,907,1071,"RODRIGUEZ  SAA, Adolfo",17,56,5,59,137,https://votaciones.hcdn.gob.ar/diputado/1071
1327,467,1709,"RODRIGUEZ GIAVARINI, Adalberto",6,4,0,3,13,https://votaciones.hcdn.gob.ar/diputado/1709
1328,800,1072,"RODRIGUEZ GONZALEZ, Oliva",21,11,0,34,66,https://votaciones.hcdn.gob.ar/diputado/1072
1329,210,1232,"RODRIGUEZ SAÑUDO, Hugo B.",80,16,2,13,111,https://votaciones.hcdn.gob.ar/diputado/1232
1330,1122,95,"RODRIGUEZ, Evaristo Arturo",308,31,3,23,365,https://votaciones.hcdn.gob.ar/diputado/95
1331,211,1069,"RODRIGUEZ, Jesus",132,61,27,109,329,https://votaciones.hcdn.gob.ar/diputado/1069
1332,212,1396,"RODRIGUEZ, José",32,1,1,77,111,https://votaciones.hcdn.gob.ar/diputado/1396
1333,213,1466,"RODRIGUEZ, Mabel E.",116,30,0,18,164,https://votaciones.hcdn.gob.ar/diputado/1466
1334,801,494,"RODRIGUEZ, Marcela Virginia",492,396,88,392,1368,https://votaciones.hcdn.gob.ar/diputado/494
1335,1523,333,"RODRIGUEZ, Matías David",152,112,4,207,475,https://votaciones.hcdn.gob.ar/diputado/333
1336,908,1070,"RODRIGUEZ, Oscar Ernesto R.",333,28,19,318,698,https://votaciones.hcdn.gob.ar/diputado/1070
1337,343,1296,"RODRIGUEZ, Raul Eduardo",7,6,0,1,14,https://votaciones.hcdn.gob.ar/diputado/1296
1338,1524,327,"RODRIGUEZ, Rodrigo Martín",187,114,8,166,475,https://votaciones.hcdn.gob.ar/diputado/327
1339,1317,211,"ROGEL, Fabián Dulio",115,121,11,160,407,https://votaciones.hcdn.gob.ar/diputado/211
1340,214,1073,"ROGGERO, Humberto Jesus",163,63,11,257,494,https://votaciones.hcdn.gob.ar/diputado/1073
1341,215,1297,"ROIG, Angel",31,47,5,28,111,https://votaciones.hcdn.gob.ar/diputado/1297
1342,1002,1074,"ROJKES de ALPEROVICH, Beatriz Liliana",589,28,0,215,832,https://votaciones.hcdn.gob.ar/diputado/1074
1343,216,1467,"ROJO, Rubén Dario",116,31,3,14,164,https://votaciones.hcdn.gob.ar/diputado/1467
1344,1123,1075,"ROLDAN, José María",117,20,7,144,288,https://votaciones.hcdn.gob.ar/diputado/1075
1345,468,1526,"ROLLANO, Eduardo Daniel",56,18,0,26,100,https://votaciones.hcdn.gob.ar/diputado/1526
1346,1525,299,"ROMA, Carlos Gastón",319,90,4,62,475,https://votaciones.hcdn.gob.ar/diputado/299
1347,670,1076,"ROMA, Rafael Edgardo",40,71,10,44,165,https://votaciones.hcdn.gob.ar/diputado/1076
1348,1030,1077,"ROMAN, Carmen",576,46,5,102,729,https://votaciones.hcdn.gob.ar/diputado/1077
1349,671,1078,"ROMANO, Antonio Anselmo",10,11,1,64,86,https://votaciones.hcdn.gob.ar/diputado/1078
1350,217,1184,"ROMERO, Carlos Alberto",73,10,1,13,97,https://votaciones.hcdn.gob.ar/diputado/1184
1351,802,1080,"ROMERO, Gabriel Luis",42,12,0,27,81,https://votaciones.hcdn.gob.ar/diputado/1080
1352,218,1397,"ROMERO, Humberto Antonio",49,8,2,52,111,https://votaciones.hcdn.gob.ar/diputado/1397
1353,563,1079,"ROMERO, Héctor Ramón",137,104,12,77,330,https://votaciones.hcdn.gob.ar/diputado/1079
1354,1622,1659,"ROMERO, Jorge Antonio",86,44,3,35,168,https://votaciones.hcdn.gob.ar/diputado/1659
1355,926,1081,"ROMERO, José Antonio",119,5,2,1,127,https://votaciones.hcdn.gob.ar/diputado/1081
1356,1402,258,"ROMERO, Oscar Alberto",375,20,9,86,490,https://votaciones.hcdn.gob.ar/diputado/258
1357,909,1082,"ROMERO, Rosario",531,29,5,133,698,https://votaciones.hcdn.gob.ar/diputado/1082
1358,1526,347,"ROQUEL, Héctor Alberto",272,45,3,26,346,https://votaciones.hcdn.gob.ar/diputado/347
1359,910,1083,"ROQUEL, Rodolfo",538,46,19,95,698,https://votaciones.hcdn.gob.ar/diputado/1083
1360,803,1084,"ROSELLI, José Alberto",20,57,5,131,213,https://votaciones.hcdn.gob.ar/diputado/1084
1361,1003,160,"ROSSI, Agustín",1101,108,11,43,1263,https://votaciones.hcdn.gob.ar/diputado/160
1362,1124,182,"ROSSI, Alejandro Luis",273,29,2,61,365,https://votaciones.hcdn.gob.ar/diputado/182
1363,1403,418,"ROSSI, Blanca Araceli",378,77,21,14,490,https://votaciones.hcdn.gob.ar/diputado/418
1364,1125,555,"ROSSI, Cipriana Lorena",189,46,22,108,365,https://votaciones.hcdn.gob.ar/diputado/555
1365,1004,1085,"ROSSO, Graciela Zulema",446,27,4,89,566,https://votaciones.hcdn.gob.ar/diputado/1085
1366,1623,1623,"ROSSO, Victoria",94,34,9,31,168,https://votaciones.hcdn.gob.ar/diputado/1623
1367,219,1086,"ROY, Irma",331,47,4,42,424,https://votaciones.hcdn.gob.ar/diputado/1086
1368,1005,1087,"ROZAS, Angel",74,48,6,357,485,https://votaciones.hcdn.gob.ar/diputado/1087
1369,469,1577,"RUBEO, Luis",51,23,0,26,100,https://votaciones.hcdn.gob.ar/diputado/1577
1370,220,1088,"RUBINI, Mirta Elsa",236,32,4,105,377,https://votaciones.hcdn.gob.ar/diputado/1088
1371,1404,232,"RUBÍN, Carlos Gustavo",425,30,4,31,490,https://votaciones.hcdn.gob.ar/diputado/232
1372,1234,505,"RUCCI, Claudia Mónica",315,55,4,256,630,https://votaciones.hcdn.gob.ar/diputado/505
1373,370,1089,"RUCKAUF, Carlos Federico",385,32,7,284,708,https://votaciones.hcdn.gob.ar/diputado/1089
1374,1527,339,"RUIZ ARAGÓN, José Arnaldo",166,102,5,202,475,https://votaciones.hcdn.gob.ar/diputado/339
1375,221,1468,"RUIZ PALACIOS, José David",54,24,0,86,164,https://votaciones.hcdn.gob.ar/diputado/1468
1376,1318,464,"RUIZ, Aida Delia",385,8,1,13,407,https://votaciones.hcdn.gob.ar/diputado/464
1377,344,1398,"RUIZ, Angel",4,0,0,10,14,https://votaciones.hcdn.gob.ar/diputado/1398
1378,1126,1090,"RUIZ, Ramón",222,17,3,69,311,https://votaciones.hcdn.gob.ar/diputado/1090
1379,1624,1644,"RUSSO, Laura",80,37,5,46,168,https://votaciones.hcdn.gob.ar/diputado/1644
1380,672,1091,"SAADE, Blanca Azucena",81,22,3,59,165,https://votaciones.hcdn.gob.ar/diputado/1091
1381,1625,1630,"SAADI, Gustavo Arturo",121,18,4,25,168,https://votaciones.hcdn.gob.ar/diputado/1630
1382,345,1399,"SAADI, Luis Alberto",1,0,0,13,14,https://votaciones.hcdn.gob.ar/diputado/1399
1383,222,1092,"SAADI, Ramón Eduardo",58,16,2,200,276,https://votaciones.hcdn.gob.ar/diputado/1092
1384,1235,282,"SABBATELLA, Martín",121,15,5,182,323,https://votaciones.hcdn.gob.ar/diputado/282
1385,346,1298,"SABIO, Juan Carlos",12,2,0,0,14,https://votaciones.hcdn.gob.ar/diputado/1298
1386,1319,295,"SACCA, Luis Fernando",97,91,8,211,407,https://votaciones.hcdn.gob.ar/diputado/295
1387,347,1400,"SACKS, Ruben Rodolfo",2,0,0,12,14,https://votaciones.hcdn.gob.ar/diputado/1400
1388,470,1578,"SAGGESE, Nestor Mario",34,30,0,36,100,https://votaciones.hcdn.gob.ar/diputado/1578
1389,1626,1634,"SAHAD, Julio Enrique",105,61,0,2,168,https://votaciones.hcdn.gob.ar/diputado/1634
1390,471,1093,"SALIM, Fernando Omar",245,64,15,311,635,https://votaciones.hcdn.gob.ar/diputado/1093
1391,1006,55,"SALIM, Juan Arturo",1016,55,5,79,1155,https://votaciones.hcdn.gob.ar/diputado/55
1392,1405,179,"SALINO, Fernando Aldo",84,29,7,63,183,https://votaciones.hcdn.gob.ar/diputado/179
1393,223,1469,"SALINO, María Antonia",93,30,0,41,164,https://votaciones.hcdn.gob.ar/diputado/1469
1394,472,1579,"SALTO, Julio Francisco José",51,19,1,29,100,https://votaciones.hcdn.gob.ar/diputado/1579
1395,1007,1094,"SALUM, Osvaldo Rubén",646,37,10,139,832,https://votaciones.hcdn.gob.ar/diputado/1094
1396,348,1233,"SALUSSO, Horacio Ramón",6,0,0,8,14,https://votaciones.hcdn.gob.ar/diputado/1233
1397,349,1299,"SALVADOR, Daniel Marcelo",6,6,0,2,14,https://votaciones.hcdn.gob.ar/diputado/1299
1398,1627,1642,"SALVAREZZA, Roberto",102,46,5,15,168,https://votaciones.hcdn.gob.ar/diputado/1642
1399,564,1095,"SALVATORI, Pedro",64,15,6,32,117,https://votaciones.hcdn.gob.ar/diputado/1095
1400,350,1401,"SAMID, Manuel Julio",3,0,0,11,14,https://votaciones.hcdn.gob.ar/diputado/1401
1401,224,1479,"SAMPIETRO, Darci",79,20,6,59,164,https://votaciones.hcdn.gob.ar/diputado/1479
1402,1406,218,"SAN MARTÍN, Adrián",287,14,2,187,490,https://votaciones.hcdn.gob.ar/diputado/218
1403,225,1300,"SANCHEZ GALDEANO, Roque",37,6,1,67,111,https://votaciones.hcdn.gob.ar/diputado/1300
1404,673,1097,"SANCHEZ, Liliana Ester",105,37,8,15,165,https://votaciones.hcdn.gob.ar/diputado/1097
1405,473,1541,"SANCHEZ, Mary",40,36,4,20,100,https://votaciones.hcdn.gob.ar/diputado/1541
1406,581,1606,"SANTA MARIA, Jose Francisco",11,2,1,7,21,https://votaciones.hcdn.gob.ar/diputado/1606
1407,474,1098,"SANTANDER, Mario Armando",481,61,21,369,932,https://votaciones.hcdn.gob.ar/diputado/1098
1408,804,1099,"SANTILLI, Diego Cesar",38,4,1,22,65,https://votaciones.hcdn.gob.ar/diputado/1099
1409,1320,293,"SANTILLÁN, Walter Marcelo",650,175,7,50,882,https://votaciones.hcdn.gob.ar/diputado/293
1410,226,80,"SANTIN, Eduardo",294,148,15,178,635,https://votaciones.hcdn.gob.ar/diputado/80
1411,1628,1636,"SAPAG, Alma Liliana",107,45,2,14,168,https://votaciones.hcdn.gob.ar/diputado/1636
1412,1148,1101,"SAPAG, Silvia Estela",117,1,0,5,123,https://votaciones.hcdn.gob.ar/diputado/1101
1413,565,1102,"SAQUER, José Luis",55,25,1,36,117,https://votaciones.hcdn.gob.ar/diputado/1102
1414,805,1103,"SAREDI, Roberto Miguel",61,15,3,2,81,https://votaciones.hcdn.gob.ar/diputado/1103
1415,1008,1104,"SARGHINI, Jorge Emilio",338,124,21,349,832,https://votaciones.hcdn.gob.ar/diputado/1104
1416,227,1480,"SARQUIZ, José Alberto",18,26,0,120,164,https://votaciones.hcdn.gob.ar/diputado/1480
1417,911,1105,"SARTORI, Diego Horacio",496,38,6,158,698,https://votaciones.hcdn.gob.ar/diputado/1105
1418,475,1580,"SAT, Oscar",55,13,2,30,100,https://votaciones.hcdn.gob.ar/diputado/1580
1419,1128,384,"SATRAGNO, Lidia Elsa",103,61,0,201,365,https://votaciones.hcdn.gob.ar/diputado/384
1420,674,1106,"SAVRON, Hayde Teresa",42,29,9,63,143,https://votaciones.hcdn.gob.ar/diputado/1106
1421,1407,559,"SCAGLIA, Gisela",388,130,9,131,658,https://votaciones.hcdn.gob.ar/diputado/559
1422,1129,81,"SCALESI, Juan Carlos",212,14,4,135,365,https://votaciones.hcdn.gob.ar/diputado/81
1423,675,1107,"SCARPIN, Delki",59,14,1,3,77,https://votaciones.hcdn.gob.ar/diputado/1107
1424,228,1402,"SCELZI, Carlos José",64,10,1,36,111,https://votaciones.hcdn.gob.ar/diputado/1402
1425,229,44,"SCHIARETTI, Juan",77,19,6,302,404,https://votaciones.hcdn.gob.ar/diputado/44
1426,1009,1109,"SCHIAVONI, Esther Aida",1,1,1,50,53,https://votaciones.hcdn.gob.ar/diputado/1109
1427,1629,1625,"SCHLERETH, David Pablo",105,61,0,2,168,https://votaciones.hcdn.gob.ar/diputado/1625
1428,1321,501,"SCHMIDT LIERMANN, Cornelia",514,244,22,102,882,https://votaciones.hcdn.gob.ar/diputado/501
1429,1408,497,"SCHWINDT, María Liliana",317,42,30,101,490,https://votaciones.hcdn.gob.ar/diputado/497
1430,566,1697,"SCIOLI, Daniel",73,43,4,181,301,https://votaciones.hcdn.gob.ar/diputado/1697
1431,1130,190,"SCIUTTO, Rubén Darío",464,74,25,209,772,https://votaciones.hcdn.gob.ar/diputado/190
1432,1425,448,"SCOTTO, Silvia Carolina",22,2,0,1,25,https://votaciones.hcdn.gob.ar/diputado/448
1433,476,1598,"SCRIMIZZI, Gloria Elida",61,15,1,0,77,https://votaciones.hcdn.gob.ar/diputado/1598
1434,230,1111,"SEBASTIANI, Claudio Augusto",111,51,2,117,281,https://votaciones.hcdn.gob.ar/diputado/1111
1435,676,1112,"SEBRIANO, Luis Alberto",68,50,0,47,165,https://votaciones.hcdn.gob.ar/diputado/1112
1436,1131,455,"SEGARRA, Adela Rosa",672,36,4,60,772,https://votaciones.hcdn.gob.ar/diputado/455
1437,351,1301,"SEGUI, Hector Miguel",8,2,0,4,14,https://votaciones.hcdn.gob.ar/diputado/1301
1438,806,1113,"SEJAS, Lisandro Mauricio",19,17,1,35,72,https://votaciones.hcdn.gob.ar/diputado/1113
1439,807,1114,"SELLARES, Francisco Nicolás",155,10,5,43,213,https://votaciones.hcdn.gob.ar/diputado/1114
1440,1528,359,"SELVA, Carlos Américo",330,40,17,88,475,https://votaciones.hcdn.gob.ar/diputado/359
1441,1409,416,"SEMHAN, María de las Mercedes",272,101,4,113,490,https://votaciones.hcdn.gob.ar/diputado/416
1442,1410,120,"SEMINARA, Eduardo Jorge",317,131,2,40,490,https://votaciones.hcdn.gob.ar/diputado/120
1443,1132,366,"SEREBRINSKY, Gustavo Eduardo",254,18,8,85,365,https://votaciones.hcdn.gob.ar/diputado/366
1444,1010,1115,"SESMA, Laura Judith",267,106,18,441,832,https://votaciones.hcdn.gob.ar/diputado/1115
1445,1630,1692,"SIERRA, Magdalena",80,38,6,44,168,https://votaciones.hcdn.gob.ar/diputado/1692
1446,1631,1694,"SILEY, Vanesa",100,46,3,19,168,https://votaciones.hcdn.gob.ar/diputado/1694
1447,583,1581,"SILVA CASANOVA, Juan Alberto",6,1,0,6,13,https://votaciones.hcdn.gob.ar/diputado/1581
1448,1322,492,"SIMONCINI, Silvia Rosa",335,7,1,64,407,https://votaciones.hcdn.gob.ar/diputado/492
1449,912,41,"SLUGA, Juan Carlos",631,38,5,389,1063,https://votaciones.hcdn.gob.ar/diputado/41
1450,375,1490,"SMITH, Santos",49,6,1,18,74,https://votaciones.hcdn.gob.ar/diputado/1490
1451,1529,291,"SNOPEK, Alejandro",320,34,13,108,475,https://votaciones.hcdn.gob.ar/diputado/291
1452,567,1116,"SNOPEK, Carlos Daniel",911,117,43,91,1162,https://votaciones.hcdn.gob.ar/diputado/1116
1453,1530,310,"SNOPEK, Guillermo",186,31,5,85,307,https://votaciones.hcdn.gob.ar/diputado/310
1454,231,1470,"SOBRINO, Margarita María",70,43,4,47,164,https://votaciones.hcdn.gob.ar/diputado/1470
1455,677,1117,"SODA, Maria Nilda",94,51,6,14,165,https://votaciones.hcdn.gob.ar/diputado/1117
1456,352,1403,"SODERO NIEVAS, Victor Hugo",7,1,1,5,14,https://votaciones.hcdn.gob.ar/diputado/1403
1457,232,16,"SOLANAS, Fernando Ezequiel",106,72,8,301,487,https://votaciones.hcdn.gob.ar/diputado/16
1458,808,98,"SOLANAS, Julio Rodolfo",693,175,16,79,963,https://votaciones.hcdn.gob.ar/diputado/98
1459,1011,1118,"SOLANAS, Raúl Patricio",645,23,3,161,832,https://votaciones.hcdn.gob.ar/diputado/1118
1460,678,1120,"SOLMOIRAGO, Raul Jorge",93,34,3,35,165,https://votaciones.hcdn.gob.ar/diputado/1120
1461,1133,13,"SOLÁ, Felipe Carlos",614,157,50,317,1138,https://votaciones.hcdn.gob.ar/diputado/13
1462,1531,496,"SORAIRE, Mirta Alicia",251,141,6,77,475,https://votaciones.hcdn.gob.ar/diputado/496
1463,1532,253,"SORGENTE, Marcelo Adolfo",147,31,1,128,307,https://votaciones.hcdn.gob.ar/diputado/253
1464,353,1234,"SORIA ARCH, José María",10,4,0,0,14,https://votaciones.hcdn.gob.ar/diputado/1234
1465,233,1122,"SORIA, Carlos Ernesto",169,79,5,41,294,https://votaciones.hcdn.gob.ar/diputado/1122
1466,477,1527,"SORIA, Edmundo del Valle",64,19,5,12,100,https://votaciones.hcdn.gob.ar/diputado/1527
1467,1411,586,"SORIA, María Emilia",331,148,5,174,658,https://votaciones.hcdn.gob.ar/diputado/586
1468,913,1123,"SOSA, Carlos Alberto",378,83,30,207,698,https://votaciones.hcdn.gob.ar/diputado/1123
1469,1533,589,"SOSA, Soledad",77,169,40,21,307,https://votaciones.hcdn.gob.ar/diputado/589
1470,1012,504,"SOTO, Gladys Beatriz",985,37,5,212,1239,https://votaciones.hcdn.gob.ar/diputado/504
1471,568,1121,"SOÑEZ, Federico Roman",57,25,0,35,117,https://votaciones.hcdn.gob.ar/diputado/1121
1472,1013,1125,"SPATOLA, Paola Rosana",434,99,37,262,832,https://votaciones.hcdn.gob.ar/diputado/1125
1473,478,1582,"SPERATTI, Alfredo Ramiro",51,20,7,22,100,https://votaciones.hcdn.gob.ar/diputado/1582
1474,234,1302,"SPINOZA, Augusto Juan",47,34,1,29,111,https://votaciones.hcdn.gob.ar/diputado/1302
1475,1412,235,"SPINOZZI, Ricardo Adrián",337,82,11,60,490,https://votaciones.hcdn.gob.ar/diputado/235
1476,1632,1704,"STEFANI, Héctor Antonio",106,59,1,2,168,https://votaciones.hcdn.gob.ar/diputado/1704
1477,927,1126,"STELLA, Anibal Jesus",477,34,18,118,647,https://votaciones.hcdn.gob.ar/diputado/1126
1478,569,433,"STOLBIZER, Margarita Rosa",429,289,26,399,1143,https://votaciones.hcdn.gob.ar/diputado/433
1479,354,1303,"STORANI, Conrado Hugo",7,6,0,1,14,https://votaciones.hcdn.gob.ar/diputado/1303
1480,235,1127,"STORANI, Federico Teobaldo",99,96,8,692,895,https://votaciones.hcdn.gob.ar/diputado/1127
1481,1236,402,"STORANI, María Luisa",158,76,3,86,323,https://votaciones.hcdn.gob.ar/diputado/402
1482,809,1128,"STORERO, Hugo",442,223,18,96,779,https://votaciones.hcdn.gob.ar/diputado/1128
1483,1134,434,"STORNI, Silvia",131,87,10,137,365,https://votaciones.hcdn.gob.ar/diputado/434
1484,479,1129,"STUBRIN, Marcelo Juan Alberto",138,59,7,61,265,https://votaciones.hcdn.gob.ar/diputado/1129
1485,1413,251,"STURZENEGGER, Federico Adolfo",81,65,8,29,183,https://votaciones.hcdn.gob.ar/diputado/251
1486,1633,1654,"SUAREZ LASTRA, Facundo",107,58,0,3,168,https://votaciones.hcdn.gob.ar/diputado/1654
1487,480,1528,"SUAREZ, Juan Carlos",63,23,0,14,100,https://votaciones.hcdn.gob.ar/diputado/1528
1488,236,1235,"SUCARIA, Nevef",75,22,2,12,111,https://votaciones.hcdn.gob.ar/diputado/1235
1489,237,1236,"SUEIRO, Carlos Adolfo",73,11,0,27,111,https://votaciones.hcdn.gob.ar/diputado/1236
1490,355,1304,"SUREDA, Angela Geronima",6,6,0,2,14,https://votaciones.hcdn.gob.ar/diputado/1304
1491,1014,1130,"SYLVESTRE BEGNIS, Juan Héctor",655,35,14,128,832,https://votaciones.hcdn.gob.ar/diputado/1130
1492,1127,301,"SÁNCHEZ, Fernando",474,208,41,193,916,https://votaciones.hcdn.gob.ar/diputado/301
1493,1534,198,"TABOADA, Jorge",247,29,10,189,475,https://votaciones.hcdn.gob.ar/diputado/198
1494,356,1237,"TACTA de ROMERO, Emma Andrea",5,1,2,6,14,https://votaciones.hcdn.gob.ar/diputado/1237
1495,582,1599,"TAGLIAFICO, Jose A.",18,9,1,5,33,https://votaciones.hcdn.gob.ar/diputado/1599
1496,1535,281,"TAILHADE, Luis Rodolfo",229,161,10,75,475,https://votaciones.hcdn.gob.ar/diputado/281
1497,810,1131,"TANONI, Enrique",100,24,6,83,213,https://votaciones.hcdn.gob.ar/diputado/1131
1498,914,1132,"TATE, Alicia Ester",259,149,22,268,698,https://votaciones.hcdn.gob.ar/diputado/1132
1499,679,1133,"TAZZIOLI, Atilio Pascual",76,31,10,47,164,https://votaciones.hcdn.gob.ar/diputado/1133
1500,1424,51,"TEJEDOR, Miguel Angel",16,8,2,17,43,https://votaciones.hcdn.gob.ar/diputado/51
1501,570,1134,"TEJERINA, Julio Alberto",63,37,2,15,117,https://votaciones.hcdn.gob.ar/diputado/1134
1502,238,1471,"TENEV, Carlos",88,15,7,54,164,https://votaciones.hcdn.gob.ar/diputado/1471
1503,1414,372,"TENTOR, Héctor Olindo",355,31,6,98,490,https://votaciones.hcdn.gob.ar/diputado/372
1504,239,1472,"TEODOSIU, Jorge Nicolas",44,61,3,56,164,https://votaciones.hcdn.gob.ar/diputado/1472
1505,1237,422,"TERADA, Alicia",476,232,28,202,938,https://votaciones.hcdn.gob.ar/diputado/422
1506,240,1482,"TERRAGNO, Rodolfo Héctor",40,34,2,56,132,https://votaciones.hcdn.gob.ar/diputado/1482
1507,1015,357,"THOMAS, Enrique Luis",721,150,9,275,1155,https://votaciones.hcdn.gob.ar/diputado/357
1508,1323,255,"TINEO, Javier Héctor",219,4,1,183,407,https://votaciones.hcdn.gob.ar/diputado/255
1509,915,1135,"TINNIRELLO, Carlos Alberto",46,146,72,434,698,https://votaciones.hcdn.gob.ar/diputado/1135
1510,241,1473,"TOGNI de VELY, Adriana Leonor",89,17,4,54,164,https://votaciones.hcdn.gob.ar/diputado/1473
1511,680,1136,"TOLEDO, Hugo David",421,64,13,365,863,https://votaciones.hcdn.gob.ar/diputado/1136
1512,1415,382,"TOLEDO, Susana María",333,98,12,47,490,https://votaciones.hcdn.gob.ar/diputado/382
1513,481,1492,"TOLOMEO, Leonor Esther",58,19,3,39,119,https://votaciones.hcdn.gob.ar/diputado/1492
1514,242,1137,"TOMA, Miguel Angel",120,55,2,97,274,https://votaciones.hcdn.gob.ar/diputado/1137
1515,1238,158,"TOMAS, Héctor Daniel",484,119,3,51,657,https://votaciones.hcdn.gob.ar/diputado/158
1516,1416,151,"TOMASSI, Néstor Nicolás",293,20,4,173,490,https://votaciones.hcdn.gob.ar/diputado/151
1517,1016,1138,"TOMAZ, Adriana Elisa",428,87,21,296,832,https://votaciones.hcdn.gob.ar/diputado/1138
1518,1017,102,"TONELLI, Pablo Gabriel",722,319,57,350,1448,https://votaciones.hcdn.gob.ar/diputado/102
1519,243,1305,"TOPA, Raúl Roque",19,25,4,52,100,https://votaciones.hcdn.gob.ar/diputado/1305
1520,1536,148,"TORELLO, Pablo",349,101,7,18,475,https://votaciones.hcdn.gob.ar/diputado/148
1521,1135,451,"TORFE, Mónica Liliana",231,42,8,84,365,https://votaciones.hcdn.gob.ar/diputado/451
1522,1018,1140,"TORINO, Héctor Omar",232,10,2,317,561,https://votaciones.hcdn.gob.ar/diputado/1140
1523,1417,155,"TORRES DEL SEL, Miguel Ignacio",65,48,7,4,124,https://votaciones.hcdn.gob.ar/diputado/155
1524,571,1142,"TORRES MOLINA, Ramon Horacio",61,32,2,22,117,https://votaciones.hcdn.gob.ar/diputado/1142
1525,916,1141,"TORRES, Francisco",32,44,14,42,132,https://votaciones.hcdn.gob.ar/diputado/1141
1526,1418,113,"TORROBA, Francisco Javier",343,93,14,40,490,https://votaciones.hcdn.gob.ar/diputado/113
1527,811,1143,"TORRONTEGUI, María Angélica",317,100,47,449,913,https://votaciones.hcdn.gob.ar/diputado/1143
1528,244,1238,"TOTO, Francisco Patricio",75,15,1,20,111,https://votaciones.hcdn.gob.ar/diputado/1238
1529,1537,1178,"TOVARES, Ramon Alberto",82,19,4,21,126,https://votaciones.hcdn.gob.ar/diputado/1178
1530,681,1144,"TREJO, Luis Alberto",99,35,4,27,165,https://votaciones.hcdn.gob.ar/diputado/1144
1531,245,1483,"TRETTEL MEYER, Raúl",71,48,1,44,164,https://votaciones.hcdn.gob.ar/diputado/1483
1532,1239,305,"TRIACA, Alberto Jorge",129,105,8,264,506,https://votaciones.hcdn.gob.ar/diputado/305
1533,1419,495,"TROIANO, Gabriela Alejandra",273,120,23,74,490,https://votaciones.hcdn.gob.ar/diputado/495
1534,246,1404,"TROYANO, Silvia Elena",41,11,10,49,111,https://votaciones.hcdn.gob.ar/diputado/1404
1535,482,1145,"TULIO, Rosa Ester",765,127,15,56,963,https://votaciones.hcdn.gob.ar/diputado/1145
1536,1420,458,"TUNDIS, Mirta",474,70,42,72,658,https://votaciones.hcdn.gob.ar/diputado/458
1537,1240,134,"TUNESSI, Juan Pedro",170,82,7,64,323,https://votaciones.hcdn.gob.ar/diputado/134
1538,572,1146,"UBALDINI, Saul Edolver",225,68,9,28,330,https://votaciones.hcdn.gob.ar/diputado/1146
1539,357,1239,"URIONDO, Luis Enrique Ramón",6,2,0,6,14,https://votaciones.hcdn.gob.ar/diputado/1239
1540,1136,103,"URLICH, Carlos",171,89,8,97,365,https://votaciones.hcdn.gob.ar/diputado/103
1541,1538,436,"URROZ, Paula",348,97,3,27,475,https://votaciones.hcdn.gob.ar/diputado/436
1542,682,1148,"URTUBEY, Juan Manuel",563,94,7,128,792,https://votaciones.hcdn.gob.ar/diputado/1148
1543,247,1185,"USANDIZAGA, Horacio Daniel",25,17,2,51,95,https://votaciones.hcdn.gob.ar/diputado/1185
1544,1031,217,"UÑAC, José Rubén",704,26,3,140,873,https://votaciones.hcdn.gob.ar/diputado/217
1545,1019,1149,"VACA NARVAJA, Patricia",548,27,3,50,628,https://votaciones.hcdn.gob.ar/diputado/1149
1546,573,1150,"VAGO, Ricardo Nicolás",77,36,0,4,117,https://votaciones.hcdn.gob.ar/diputado/1150
1547,248,1405,"VALCARCEL, Juan Manuel",95,20,3,93,211,https://votaciones.hcdn.gob.ar/diputado/1405
1548,574,1151,"VALDOVINOS, Arnaldo Pastor",46,37,0,34,117,https://votaciones.hcdn.gob.ar/diputado/1151
1549,1421,272,"VALDÉS, Gustavo Adolfo",251,76,9,154,490,https://votaciones.hcdn.gob.ar/diputado/272
1550,1324,9,"VALINOTTO, Jorge Anselmo",131,103,23,150,407,https://votaciones.hcdn.gob.ar/diputado/9
1551,1634,1701,"VALLEJOS, María Fernanda",37,12,2,117,168,https://votaciones.hcdn.gob.ar/diputado/1701
1552,1635,1618,"VALLONE, Andres Alberto",59,16,10,83,168,https://votaciones.hcdn.gob.ar/diputado/1618
1553,358,1152,"VANOSSI, Jorge",215,90,28,379,712,https://votaciones.hcdn.gob.ar/diputado/1152
1554,1325,373,"VAQUIE, Enrique Andrés",135,126,8,138,407,https://votaciones.hcdn.gob.ar/diputado/373
1555,359,1306,"VARELA BARRIOS, Juan Carlos",9,2,2,1,14,https://votaciones.hcdn.gob.ar/diputado/1306
1556,249,1240,"VARELA CID, Eduardo",60,12,5,34,111,https://votaciones.hcdn.gob.ar/diputado/1240
1557,250,1406,"VARELA, Nestor Angel",39,5,3,64,111,https://votaciones.hcdn.gob.ar/diputado/1406
1558,683,1153,"VARESE, Luis Segundo",40,13,1,30,84,https://votaciones.hcdn.gob.ar/diputado/1153
1559,917,280,"VARGAS AIGNASSE, Gerónimo",692,49,17,296,1054,https://votaciones.hcdn.gob.ar/diputado/280
1560,1020,1154,"VARISCO, Sergio Fausto",156,144,11,521,832,https://votaciones.hcdn.gob.ar/diputado/1154
1561,918,1155,"VARIZAT, Daniel Alberto",143,7,0,9,159,https://votaciones.hcdn.gob.ar/diputado/1155
1562,1636,1699,"VAZQUEZ, Juan Benedicto",64,21,7,76,168,https://votaciones.hcdn.gob.ar/diputado/1699
1563,360,1156,"VAZQUEZ, Ricardo Hector",101,46,4,28,179,https://votaciones.hcdn.gob.ar/diputado/1156
1564,251,1407,"VAZQUEZ, Roberto",25,5,1,80,111,https://votaciones.hcdn.gob.ar/diputado/1407
1565,252,470,"VAZQUEZ, Silvia Beatriz",271,74,12,289,646,https://votaciones.hcdn.gob.ar/diputado/470
1566,1241,516,"VEAUTE, Mariana Alejandra",100,76,3,144,323,https://votaciones.hcdn.gob.ar/diputado/516
1567,1137,53,"VEGA, Juan Carlos",110,42,14,199,365,https://votaciones.hcdn.gob.ar/diputado/53
1568,1539,522,"VEGA, María Clara del Valle",241,37,2,27,307,https://votaciones.hcdn.gob.ar/diputado/522
1569,1021,1157,"VELARDE, Marta Sylvia",561,87,6,178,832,https://votaciones.hcdn.gob.ar/diputado/1157
1570,253,1241,"VENESIA, Gualberto Edgardo",67,13,0,31,111,https://votaciones.hcdn.gob.ar/diputado/1241
1571,575,1158,"VENICA, Pedro Antonio",64,28,3,235,330,https://votaciones.hcdn.gob.ar/diputado/1158
1572,483,1542,"VENSENTINI, Marcelo Edmundo",44,31,1,24,100,https://votaciones.hcdn.gob.ar/diputado/1542
1573,1540,1180,"VERA GONZALEZ, Orieta Cecilia",173,78,0,38,289,https://votaciones.hcdn.gob.ar/diputado/1180
1574,1145,1159,"VERA, Pedro Ramón Ademar",20,0,0,2,22,https://votaciones.hcdn.gob.ar/diputado/1159
1575,484,1583,"VERAMENDI, Juan Carlos",68,17,0,15,100,https://votaciones.hcdn.gob.ar/diputado/1583
1576,1138,244,"VIALE, Lisandro Alfredo",211,91,4,59,365,https://votaciones.hcdn.gob.ar/diputado/244
1577,485,1529,"VIAÑA, Mariano Roberto",52,18,3,27,100,https://votaciones.hcdn.gob.ar/diputado/1529
1578,254,1307,"VICCHI, Raúl Horacio",67,87,1,56,211,https://votaciones.hcdn.gob.ar/diputado/1307
1579,1242,517,"VIDELA, Nora Esther",134,55,4,130,323,https://votaciones.hcdn.gob.ar/diputado/517
1580,255,1484,"VIGLIONE, Atilio Oscar",79,54,0,31,164,https://votaciones.hcdn.gob.ar/diputado/1484
1581,1637,1682,"VIGO, Alejandra María",75,10,4,79,168,https://votaciones.hcdn.gob.ar/diputado/1682
1582,1139,367,"VILARIÑO, José Antonio",670,39,6,57,772,https://votaciones.hcdn.gob.ar/diputado/367
1583,486,1530,"VILCHE, Carlos Alberto",64,22,2,12,100,https://votaciones.hcdn.gob.ar/diputado/1530
1584,1326,52,"VILLA, José Antonio",285,7,0,115,407,https://votaciones.hcdn.gob.ar/diputado/52
1585,1638,1660,"VILLA, Natalia Soledad",106,57,0,5,168,https://votaciones.hcdn.gob.ar/diputado/1660
1586,487,1160,"VILLALBA, Alfredo Horacio",118,79,7,61,265,https://votaciones.hcdn.gob.ar/diputado/1160
1587,1541,175,"VILLALONGA, Juan Carlos",357,95,1,22,475,https://votaciones.hcdn.gob.ar/diputado/175
1588,1422,481,"VILLAR MOLINA, María Inés",395,23,1,71,490,https://votaciones.hcdn.gob.ar/diputado/481
1589,1327,364,"VILLATA, Graciela Susana",147,134,23,103,407,https://votaciones.hcdn.gob.ar/diputado/364
1590,812,1161,"VILLAVERDE, Jorge Antonio",613,70,9,353,1045,https://votaciones.hcdn.gob.ar/diputado/1161
1591,1542,556,"VILLAVICENCIO, María Teresita",358,61,12,44,475,https://votaciones.hcdn.gob.ar/diputado/556
1592,361,1408,"VIQUEIRA, Horacio",41,26,1,46,114,https://votaciones.hcdn.gob.ar/diputado/1408
1593,813,1162,"VITALE, Domingo",170,14,12,17,213,https://votaciones.hcdn.gob.ar/diputado/1162
1594,256,1163,"VITAR, Jose Alberto",120,78,17,114,329,https://votaciones.hcdn.gob.ar/diputado/1163
1595,814,1164,"VIVO, Horacio",31,10,1,7,49,https://votaciones.hcdn.gob.ar/diputado/1164
1596,576,1165,"VOLANDO, Humberto Antonio",83,22,2,10,117,https://votaciones.hcdn.gob.ar/diputado/1165
1597,1543,525,"VOLNOVICH, Luana",208,144,8,115,475,https://votaciones.hcdn.gob.ar/diputado/525
1598,815,1166,"WALSH, Patricia",27,128,10,48,213,https://votaciones.hcdn.gob.ar/diputado/1166
1599,1243,129,"WAYAR, Walter Raúl",245,21,6,51,323,https://votaciones.hcdn.gob.ar/diputado/129
1600,1544,228,"WECHSLER, Marcelo Germán",372,98,2,3,475,https://votaciones.hcdn.gob.ar/diputado/228
1601,1639,1616,"WELLBACH, Ricardo",108,15,0,45,168,https://votaciones.hcdn.gob.ar/diputado/1616
1602,1022,15,"WEST, Mariano Federíco",786,52,3,90,931,https://votaciones.hcdn.gob.ar/diputado/15
1603,919,1167,"WILDER, Ricardo",367,55,14,262,698,https://votaciones.hcdn.gob.ar/diputado/1167
1604,1545,225,"WISKY, Sergio Javier",353,87,1,34,475,https://votaciones.hcdn.gob.ar/diputado/225
1605,1546,276,"WOLFF, Waldo Ezequiel",358,94,4,19,475,https://votaciones.hcdn.gob.ar/diputado/276
1606,1329,476,"YAGÛE, Linda Cristina",75,63,3,92,233,https://votaciones.hcdn.gob.ar/diputado/476
1607,1244,267,"YARADE, Rodolfo Fernando",254,24,4,41,323,https://votaciones.hcdn.gob.ar/diputado/267
1608,712,1168,"YAREGUI, Alberto",2,5,1,2,10,https://votaciones.hcdn.gob.ar/diputado/1168
1609,1640,1669,"YASKY, Hugo",67,37,2,62,168,https://votaciones.hcdn.gob.ar/diputado/1669
1610,1330,30,"YAZBEK, Rubén David",217,3,1,3,224,https://votaciones.hcdn.gob.ar/diputado/30
1611,1641,1700,"YEDLIN, Pablo Raúl",140,15,5,8,168,https://votaciones.hcdn.gob.ar/diputado/1700
1612,362,105,"YOMA, Jorge Raul",94,66,3,174,337,https://votaciones.hcdn.gob.ar/diputado/105
1613,363,1409,"ZABALA, Gilberto Antonio",7,2,0,5,14,https://votaciones.hcdn.gob.ar/diputado/1409
1614,1331,22,"ZABALZA, Juan Carlos",132,125,21,129,407,https://votaciones.hcdn.gob.ar/diputado/22
1615,577,1169,"ZACARIAS, Juan Domingo",29,21,20,47,117,https://votaciones.hcdn.gob.ar/diputado/1169
1616,1642,1610,"ZAMARBIDE, Federico Raúl",100,58,1,9,168,https://votaciones.hcdn.gob.ar/diputado/1610
1617,1333,571,"ZAMARREÑO, María Eugenia",383,8,1,1,393,https://votaciones.hcdn.gob.ar/diputado/571
1618,364,1308,"ZAMBIANCHI, Carlos",6,2,0,6,14,https://votaciones.hcdn.gob.ar/diputado/1308
1619,1643,1685,"ZAMORA, Claudia",66,13,1,88,168,https://votaciones.hcdn.gob.ar/diputado/1685
1620,365,1410,"ZAMORA, Federico",1,0,0,13,14,https://votaciones.hcdn.gob.ar/diputado/1410
1621,366,1170,"ZAMORA, Luis Fernando",13,102,21,91,227,https://votaciones.hcdn.gob.ar/diputado/1170
1622,1023,1171,"ZANCADA, Pablo Ventura",478,155,18,181,832,https://votaciones.hcdn.gob.ar/diputado/1171
1623,578,1172,"ZAPATA MERCADER, Jorge",41,37,7,32,117,https://votaciones.hcdn.gob.ar/diputado/1172
1624,367,1411,"ZARACHO, Evelio Argentino",6,2,0,6,14,https://votaciones.hcdn.gob.ar/diputado/1411
1625,257,1485,"ZAVALIA, José Luis",25,26,1,145,197,https://votaciones.hcdn.gob.ar/diputado/1485
1626,1140,285,"ZAVALLO, Gustavo Marcelo",246,37,3,79,365,https://votaciones.hcdn.gob.ar/diputado/285
1627,1024,1173,"ZBAR, Agustín",4,7,0,0,11,https://votaciones.hcdn.gob.ar/diputado/1173
1628,258,1242,"ZICARELLI, Orlando",69,12,1,29,111,https://votaciones.hcdn.gob.ar/diputado/1242
1629,1332,420,"ZIEBART, Cristina Isabel",381,8,1,17,407,https://votaciones.hcdn.gob.ar/diputado/420
1630,1245,374,"ZIEGLER, Alex Roberto",658,64,6,85,813,https://votaciones.hcdn.gob.ar/diputado/374
1631,1547,196,"ZILIOTTO, Sergio Raúl",347,28,13,87,475,https://votaciones.hcdn.gob.ar/diputado/196
1632,920,1174,"ZIMMERMANN, Víctor",219,169,30,280,698,https://votaciones.hcdn.gob.ar/diputado/1174
1633,816,1675,"ZOTTOS, Miguel Andrés Costas",373,157,52,343,925,https://votaciones.hcdn.gob.ar/diputado/1675
1634,259,1481,"ZUCCARDI de FLAMARIQUE, María",52,28,1,83,164,https://votaciones.hcdn.gob.ar/diputado/1481
1635,684,1176,"ZUCCARDI, Cristina",62,24,6,73,165,https://votaciones.hcdn.gob.ar/diputado/1176
1636,685,1177,"ZUÑIGA, Ovidio Octavio",70,61,7,27,165,https://votaciones.hcdn.gob.ar/diputado/1177
1637,964,546,"di TULLIO, Juliana",1190,162,6,287,1645,https://votaciones.hcdn.gob.ar/diputado/546
1638,1328,162,"xx BORRAR, Manuel Isauro",388,8,0,11,407,https://votaciones.hcdn.gob.ar/diputado/162
1639,931,523,"ÁLVAREZ RODRIGUEZ, María Cristina",588,168,16,269,1041,https://votaciones.hcdn.gob.ar/diputado/523
1640,1558,1626,"ÁVILA, Beatriz Luisa",77,56,0,35,168,https://votaciones.hcdn.gob.ar/diputado/1626
